"seed","map_idx","merit_mean","merit_median","merit_sd","nutrients_consumed_mean","nutrients_consumed_median","nutrients_consumed_sd","moves_off_path_mean","moves_off_path_median","moves_off_path_sd","base_score_mean","base_score_median","base_score_sd","seed_order","category"
1,0,4.21985e+14,4.21985e+14,0,356,356,0,63,63,0,293,293,0,23,"Set pattern"
1,1,3.29472e+11,3.29472e+11,0,341,341,0,82,82,0,259,259,0,23,"Set pattern"
1,2,1.60889e+11,1.60889e+11,0,337,337,0,85,85,0,252,252,0,23,"Set pattern"
1,3,16739100000,16739100000,0,418,418,0,0,0,0,418,418,0,23,"Set pattern"
2,0,2.3206e+20,2.3206e+20,0,487,487,0,79,79,0,408,408,0,96,"Pattern cycling"
2,1,1.02444e+18,1.02444e+18,0,483,483,0,78,78,0,405,405,0,96,"Pattern cycling"
2,2,9.69404e+14,9.69404e+14,0,466,466,0,129,129,0,337,337,0,96,"Pattern cycling"
2,3,1.03473e+14,1.03473e+14,0,573,573,0,0,0,0,573,573,0,96,"Pattern cycling"
3,0,3.31441e+17,3.31441e+17,0,427,427,0,76,76,0,351,351,0,125,"Pattern cycling"
3,1,1.98517e+15,1.98517e+15,0,414,414,0,70,70,0,344,344,0,125,"Pattern cycling"
3,2,2.31785e+16,2.31785e+16,0,462,462,0,94,94,0,368,368,0,125,"Pattern cycling"
3,3,8.68251e+12,8.68251e+12,0,529,529,0,0,0,0,529,529,0,125,"Pattern cycling"
4,0,2.60325e+20,2.60325e+20,0,451,451,0,42,42,0,409,409,0,165,"Pattern cycling"
4,1,3.1683e+20,3.1683e+20,0,500,500,0,39,39,0,461,461,0,165,"Pattern cycling"
4,2,5.27246e+18,5.27246e+18,0,462,462,0,41,41,0,421,421,0,165,"Pattern cycling"
4,3,5.7786e+10,5.7786e+10,0,479,479,0,39,39,0,440,440,0,165,"Pattern cycling"
5,0,1.19649e+13,1.19649e+13,0,265,265,0,3,3,0,262,262,0,9,"Pattern cycling"
5,1,16911300000,16911300000,0,243,243,0,13,13,0,230,230,0,9,"Pattern cycling"
5,2,47084900000,47084900000,0,262,262,0,22,22,0,240,240,0,9,"Pattern cycling"
5,3,32271300,32271300,0,316,316,0,9,9,0,307,307,0,9,"Pattern cycling"
6,0,2.69583e+11,2.69583e+11,0,235,235,0,6,6,0,229,229,0,14,"Pattern cycling"
6,1,2.18744e+11,2.18744e+11,0,258,258,0,3,3,0,255,255,0,14,"Pattern cycling"
6,2,64016600000,64016600000,0,246,246,0,3,3,0,243,243,0,14,"Pattern cycling"
6,3,79461400,79461400,0,334,334,0,11,11,0,323,323,0,14,"Pattern cycling"
7,0,1.05015e+17,1.05015e+17,0,370,370,0,29,29,0,341,341,0,129,"Pattern cycling"
7,1,1.88862e+16,1.88862e+16,0,393,393,0,27,27,0,366,366,0,129,"Pattern cycling"
7,2,1.70938e+18,1.70938e+18,0,437,437,0,27,27,0,410,410,0,129,"Pattern cycling"
7,3,1.71773e+14,1.71773e+14,0,602,602,0,20,20,0,582,582,0,129,"Pattern cycling"
8,0,5.37263e+11,5.37263e+11,0,240,240,0,5,5,0,235,235,0,15,"Pattern cycling"
8,1,8.7037e+10,8.7037e+10,0,252,252,0,6,6,0,246,246,0,15,"Pattern cycling"
8,2,78565800000,78565800000,0,265,265,0,20,20,0,245,245,0,15,"Pattern cycling"
8,3,1541870,1541870,0,258,258,0,5,5,0,253,253,0,15,"Pattern cycling"
9,0,3.66081e+21,3.66081e+21,0,520,520,0,88,88,0,432,432,0,105,"Set pattern"
9,1,1.18972e+15,1.18972e+15,0,496,496,0,157,157,0,339,339,0,105,"Set pattern"
9,2,2.19921e+15,2.19921e+15,0,487,487,0,142,142,0,345,345,0,105,"Set pattern"
9,3,4.47459e+14,4.47459e+14,0,599,599,0,0,0,0,599,599,0,105,"Set pattern"
10,0,1.70228e+11,1.70228e+11,0,249,249,0,24,24,0,225,225,0,7,"Pattern cycling"
10,1,1307430000,1307430000,0,211,211,0,6,6,0,205,205,0,7,"Pattern cycling"
10,2,12438500000,12438500000,0,280,280,0,53,53,0,227,227,0,7,"Pattern cycling"
10,3,124688000,124688000,0,336,336,0,5,5,0,331,331,0,7,"Pattern cycling"
11,0,5.84268e+19,5.84268e+19,0,399,399,0,3,3,0,396,396,0,167,"Plowing"
11,1,8.79762e+18,8.79762e+18,0,429,429,0,3,3,0,426,426,0,167,"Plowing"
11,2,1.54716e+20,1.54716e+20,0,457,457,0,3,3,0,454,454,0,167,"Plowing"
11,3,6.63689e+14,6.63689e+14,0,609,609,0,3,3,0,606,606,0,167,"Plowing"
12,0,1.86564e+17,1.86564e+17,0,370,370,0,24,24,0,346,346,0,106,"Pattern cycling"
12,1,7.89885e+14,7.89885e+14,0,431,431,0,96,96,0,335,335,0,106,"Pattern cycling"
12,2,2.43634e+15,2.43634e+15,0,484,484,0,138,138,0,346,346,0,106,"Pattern cycling"
12,3,9.71769e+12,9.71769e+12,0,557,557,0,26,26,0,531,531,0,106,"Pattern cycling"
13,0,5.75264e+23,5.75264e+23,0,535,535,0,59,59,0,476,476,0,135,"Pattern cycling"
13,1,3.15135e+16,3.15135e+16,0,510,510,0,139,139,0,371,371,0,135,"Pattern cycling"
13,2,2.84463e+16,2.84463e+16,0,483,483,0,113,113,0,370,370,0,135,"Pattern cycling"
13,3,8.79545e+14,8.79545e+14,0,611,611,0,0,0,0,611,611,0,135,"Pattern cycling"
14,0,5.33107e+13,5.33107e+13,0,291,291,0,16,16,0,275,275,0,18,"Pattern cycling"
14,1,1.18335e+11,1.18335e+11,0,275,275,0,26,26,0,249,249,0,18,"Pattern cycling"
14,2,6.747e+11,6.747e+11,0,282,282,0,16,16,0,266,266,0,18,"Pattern cycling"
14,3,94087500,94087500,0,330,330,0,4,4,0,326,326,0,18,"Pattern cycling"
15,0,8.37731e+15,8.37731e+15,0,331,331,0,12,12,0,319,319,0,124,"Pattern cycling"
15,1,1.2539e+16,1.2539e+16,0,381,381,0,19,19,0,362,362,0,124,"Pattern cycling"
15,2,2.19921e+15,2.19921e+15,0,374,374,0,29,29,0,345,345,0,124,"Pattern cycling"
15,3,3.5262e+12,3.5262e+12,0,533,533,0,20,20,0,513,513,0,124,"Pattern cycling"
16,0,5.16802e+21,5.16802e+21,0,471,471,0,36,36,0,435,435,0,182,"Pattern cycling"
16,1,1.47191e+21,1.47191e+21,0,502,502,0,26,26,0,476,476,0,182,"Pattern cycling"
16,2,9.29711e+21,9.29711e+21,0,542,542,0,48,48,0,494,494,0,182,"Pattern cycling"
16,3,2.36639e+20,2.36639e+20,0,907,907,0,74,74,0,833,833,0,182,"Pattern cycling"
17,0,1.69568e+12,1.69568e+12,0,256,256,0,11,11,0,245,245,0,17,"Pattern cycling"
17,1,1.06818e+11,1.06818e+11,0,250,250,0,2,2,0,248,248,0,17,"Pattern cycling"
17,2,64016600000,64016600000,0,260,260,0,17,17,0,243,243,0,17,"Pattern cycling"
17,3,1.99486e+11,1.99486e+11,0,464,464,0,2,2,0,462,462,0,17,"Pattern cycling"
18,0,9.43423e+14,9.43423e+14,0,341,341,0,41,41,0,300,300,0,93,"Pattern cycling"
18,1,1.318e+15,1.318e+15,0,351,351,0,11,11,0,340,340,0,93,"Pattern cycling"
18,2,5.80969e+14,5.80969e+14,0,366,366,0,34,34,0,332,332,0,93,"Pattern cycling"
18,3,6667660,6667660,0,280,280,0,1,1,0,279,279,0,93,"Pattern cycling"
19,0,1.48827e+16,1.48827e+16,0,332,332,0,8,8,0,324,324,0,88,"Pattern cycling"
19,1,5.80969e+14,5.80969e+14,0,340,340,0,8,8,0,332,332,0,88,"Pattern cycling"
19,2,1.70023e+14,1.70023e+14,0,328,328,0,8,8,0,320,320,0,88,"Pattern cycling"
19,3,206992000,206992000,0,346,346,0,6,6,0,340,340,0,88,"Pattern cycling"
20,0,1.6311e+22,1.6311e+22,0,521,521,0,76,76,0,445,445,0,79,"Set pattern"
20,1,1.3891e+16,1.3891e+16,0,493,493,0,130,130,0,363,363,0,79,"Set pattern"
20,2,3.65977e+13,3.65977e+13,0,465,465,0,160,160,0,305,305,0,79,"Set pattern"
20,3,2.03391e+14,2.03391e+14,0,585,585,0,0,0,0,585,585,0,79,"Set pattern"
21,0,5.9804e+13,5.9804e+13,0,284,284,0,8,8,0,276,276,0,52,"Pattern cycling"
21,1,1.61321e+13,1.61321e+13,0,304,304,0,7,7,0,297,297,0,52,"Pattern cycling"
21,2,6.41886e+12,6.41886e+12,0,304,304,0,16,16,0,288,288,0,52,"Pattern cycling"
21,3,5031300,5031300,0,274,274,0,0,0,0,274,274,0,52,"Pattern cycling"
22,0,2.33869e+18,2.33869e+18,0,386,386,0,18,18,0,368,368,0,158,"Pattern cycling"
22,1,9.24735e+17,9.24735e+17,0,416,416,0,12,12,0,404,404,0,158,"Pattern cycling"
22,2,1.13795e+20,1.13795e+20,0,485,485,0,34,34,0,451,451,0,158,"Pattern cycling"
22,3,1.3981e+17,1.3981e+17,0,713,713,0,12,12,0,701,701,0,158,"Pattern cycling"
23,0,8.31251e+17,8.31251e+17,0,470,470,0,111,111,0,359,359,0,59,"Set pattern"
23,1,1.97985e+13,1.97985e+13,0,449,449,0,150,150,0,299,299,0,59,"Set pattern"
23,2,7.13007e+14,7.13007e+14,0,457,457,0,123,123,0,334,334,0,59,"Set pattern"
23,3,2.39278e+13,2.39278e+13,0,560,560,0,13,13,0,547,547,0,59,"Set pattern"
24,0,5.93414e+15,5.93414e+15,0,336,336,0,20,20,0,316,316,0,121,"Pattern cycling"
24,1,4.5157e+17,4.5157e+17,0,409,409,0,12,12,0,397,397,0,121,"Pattern cycling"
24,2,1.19292e+17,1.19292e+17,0,410,410,0,26,26,0,384,384,0,121,"Pattern cycling"
24,3,4.73383e+14,4.73383e+14,0,615,615,0,15,15,0,600,600,0,121,"Pattern cycling"
25,0,4.67901e+17,4.67901e+17,0,411,411,0,57,57,0,354,354,0,144,"Pattern cycling"
25,1,2.20512e+17,2.20512e+17,0,404,404,0,14,14,0,390,390,0,144,"Pattern cycling"
25,2,7.55513e+19,7.55513e+19,0,479,479,0,32,32,0,447,447,0,144,"Pattern cycling"
25,3,3.03633e+15,3.03633e+15,0,647,647,0,14,14,0,633,633,0,144,"Pattern cycling"
26,0,3.01247e+12,3.01247e+12,0,265,265,0,15,15,0,250,250,0,13,"Pattern cycling"
26,1,34631400000,34631400000,0,251,251,0,14,14,0,237,237,0,13,"Pattern cycling"
26,2,5.7786e+10,5.7786e+10,0,258,258,0,16,16,0,242,242,0,13,"Pattern cycling"
26,3,5031300,5031300,0,292,292,0,18,18,0,274,274,0,13,"Pattern cycling"
27,0,1.47104e+19,1.47104e+19,0,426,426,0,42,42,0,384,384,0,38,"Set pattern"
27,1,2.82941e+12,2.82941e+12,0,378,378,0,98,98,0,280,280,0,38,"Set pattern"
27,2,1.4562e+13,1.4562e+13,0,390,390,0,94,94,0,296,296,0,38,"Set pattern"
27,3,1.99486e+11,1.99486e+11,0,465,465,0,3,3,0,462,462,0,38,"Set pattern"
28,0,1.48827e+16,1.48827e+16,0,350,350,0,26,26,0,324,324,0,45,"Set pattern"
28,1,1.07105e+13,1.07105e+13,0,335,335,0,42,42,0,293,293,0,45,"Set pattern"
28,2,1.4562e+13,1.4562e+13,0,336,336,0,40,40,0,296,296,0,45,"Set pattern"
28,3,84064900,84064900,0,350,350,0,26,26,0,324,324,0,45,"Set pattern"
29,0,1.85121e+19,1.85121e+19,0,387,387,0,1,1,0,386,386,0,164,"Pattern cycling"
29,1,1.25727e+18,1.25727e+18,0,410,410,0,3,3,0,407,407,0,164,"Pattern cycling"
29,2,3.87795e+18,3.87795e+18,0,420,420,0,2,2,0,418,418,0,164,"Pattern cycling"
29,3,1.45071e+14,1.45071e+14,0,585,585,0,6,6,0,579,579,0,164,"Pattern cycling"
30,0,5.33107e+13,5.33107e+13,0,284,284,0,9,9,0,275,275,0,46,"Set pattern"
30,1,1.07105e+13,1.07105e+13,0,293,293,0,0,0,0,293,293,0,46,"Set pattern"
30,2,70919100000,70919100000,0,270,270,0,26,26,0,244,244,0,46,"Set pattern"
30,3,14668800,14668800,0,293,293,0,0,0,0,293,293,0,46,"Set pattern"
31,0,1.89484e+13,1.89484e+13,0,289,289,0,23,23,0,266,266,0,56,"Pattern cycling"
31,1,1.38538e+14,1.38538e+14,0,337,337,0,19,19,0,318,318,0,56,"Pattern cycling"
31,2,1.4562e+13,1.4562e+13,0,329,329,0,33,33,0,296,296,0,56,"Pattern cycling"
31,3,4.67304e+12,4.67304e+12,0,576,576,0,58,58,0,518,518,0,56,"Pattern cycling"
32,0,8.4099e+14,8.4099e+14,0,347,347,0,48,48,0,299,299,0,54,"Pattern cycling"
32,1,1.78715e+13,1.78715e+13,0,318,318,0,20,20,0,298,298,0,54,"Pattern cycling"
32,2,3.30357e+13,3.30357e+13,0,379,379,0,75,75,0,304,304,0,54,"Pattern cycling"
32,3,1.69568e+12,1.69568e+12,0,500,500,0,0,0,0,500,500,0,54,"Pattern cycling"
33,0,9.32498e+17,9.32498e+17,0,382,382,0,22,22,0,360,360,0,102,"Pattern cycling"
33,1,7.13007e+14,7.13007e+14,0,421,421,0,87,87,0,334,334,0,102,"Pattern cycling"
33,2,1.46011e+15,1.46011e+15,0,378,378,0,37,37,0,341,341,0,102,"Pattern cycling"
33,3,259292000,259292000,0,344,344,0,0,0,0,344,344,0,102,"Pattern cycling"
34,0,4.75224e+13,4.75224e+13,0,336,336,0,62,62,0,274,274,0,5,"Pattern cycling"
34,1,38365500000,38365500000,0,284,284,0,46,46,0,238,238,0,5,"Pattern cycling"
34,2,9148630000,9148630000,0,317,317,0,93,93,0,224,224,0,5,"Pattern cycling"
34,3,5129780000,5129780000,0,397,397,0,0,0,0,397,397,0,5,"Pattern cycling"
35,0,3.31441e+17,3.31441e+17,0,359,359,0,8,8,0,351,351,0,12,"Set pattern"
35,1,1.97454e+11,1.97454e+11,0,335,335,0,81,81,0,254,254,0,12,"Set pattern"
35,2,18734800000,18734800000,0,299,299,0,68,68,0,231,231,0,12,"Set pattern"
35,3,946974000,946974000,0,367,367,0,0,0,0,367,367,0,12,"Set pattern"
36,0,1.47104e+19,1.47104e+19,0,427,427,0,43,43,0,384,384,0,136,"Pattern cycling"
36,1,6.13954e+17,6.13954e+17,0,466,466,0,66,66,0,400,400,0,136,"Pattern cycling"
36,2,3.15135e+16,3.15135e+16,0,431,431,0,60,60,0,371,371,0,136,"Pattern cycling"
36,3,1.27953e+12,1.27953e+12,0,526,526,0,31,31,0,495,495,0,136,"Pattern cycling"
37,0,9.36125e+16,9.36125e+16,0,389,389,0,49,49,0,340,340,0,31,"Set pattern"
37,1,6.747e+11,6.747e+11,0,362,362,0,96,96,0,266,266,0,31,"Set pattern"
37,2,5.7786e+10,5.7786e+10,0,346,346,0,104,104,0,242,242,0,31,"Set pattern"
37,3,2.9398e+10,2.9398e+10,0,428,428,0,0,0,0,428,428,0,31,"Set pattern"
38,0,8.37731e+15,8.37731e+15,0,369,369,0,50,50,0,319,319,0,22,"Set pattern"
38,1,2677390000,2677390000,0,318,318,0,106,106,0,212,212,0,22,"Set pattern"
38,2,2.4233e+11,2.4233e+11,0,340,340,0,84,84,0,256,256,0,22,"Set pattern"
38,3,1759480000,1759480000,0,398,398,0,20,20,0,378,378,0,22,"Set pattern"
39,0,1.66955e+16,1.66955e+16,0,444,444,0,119,119,0,325,325,0,74,"Set pattern"
39,1,4.97582e+13,4.97582e+13,0,438,438,0,130,130,0,308,308,0,74,"Set pattern"
39,2,1.53475e+14,1.53475e+14,0,441,441,0,122,122,0,319,319,0,74,"Set pattern"
39,3,1.28782e+13,1.28782e+13,0,548,548,0,12,12,0,536,536,0,74,"Set pattern"
40,0,5.24891e+17,5.24891e+17,0,439,439,0,84,84,0,355,355,0,40,"Set pattern"
40,1,1.07105e+13,1.07105e+13,0,412,412,0,119,119,0,293,293,0,40,"Set pattern"
40,2,5.23019e+12,5.23019e+12,0,408,408,0,122,122,0,286,286,0,40,"Set pattern"
40,3,3.3331e+12,3.3331e+12,0,514,514,0,2,2,0,512,512,0,40,"Set pattern"
41,0,4.12268e+20,4.12268e+20,0,413,413,0,0,0,0,413,413,0,176,"Pattern cycling"
41,1,8.36975e+19,8.36975e+19,0,466,466,0,18,18,0,448,448,0,176,"Pattern cycling"
41,2,1.13795e+20,1.13795e+20,0,479,479,0,28,28,0,451,451,0,176,"Pattern cycling"
41,3,1.62367e+14,1.62367e+14,0,581,581,0,0,0,0,581,581,0,176,"Pattern cycling"
42,0,2.14221e+11,2.14221e+11,0,227,227,0,0,0,0,227,227,0,8,"Set pattern"
42,1,12438500000,12438500000,0,227,227,0,0,0,0,227,227,0,8,"Set pattern"
42,2,5482830000,5482830000,0,223,223,0,4,4,0,219,219,0,8,"Set pattern"
42,3,356551,356551,0,227,227,0,0,0,0,227,227,0,8,"Set pattern"
43,0,6.60542e+17,6.60542e+17,0,460,460,0,103,103,0,357,357,0,153,"Pattern cycling"
43,1,8.34732e+17,8.34732e+17,0,469,469,0,66,66,0,403,403,0,153,"Pattern cycling"
43,2,7.14922e+16,7.14922e+16,0,476,476,0,97,97,0,379,379,0,153,"Pattern cycling"
43,3,9.90789e+15,9.90789e+15,0,662,662,0,8,8,0,654,654,0,153,"Pattern cycling"
44,0,1.30118e+21,1.30118e+21,0,444,444,0,21,21,0,423,423,0,173,"Pattern cycling"
44,1,4.08715e+19,4.08715e+19,0,445,445,0,4,4,0,441,441,0,173,"Pattern cycling"
44,2,7.55513e+19,7.55513e+19,0,479,479,0,32,32,0,447,447,0,173,"Pattern cycling"
44,3,4.76451e+15,4.76451e+15,0,641,641,0,0,0,0,641,641,0,173,"Pattern cycling"
45,0,1.85121e+19,1.85121e+19,0,398,398,0,12,12,0,386,386,0,172,"Pattern cycling"
45,1,5.01604e+19,5.01604e+19,0,459,459,0,16,16,0,443,443,0,172,"Pattern cycling"
45,2,2.11483e+24,2.11483e+24,0,567,567,0,20,20,0,547,547,0,172,"Pattern cycling"
45,3,1.91015e+13,1.91015e+13,0,547,547,0,4,4,0,543,543,0,172,"Pattern cycling"
46,0,1.33703e+14,1.33703e+14,0,327,327,0,44,44,0,283,283,0,53,"Pattern cycling"
46,1,1.61321e+13,1.61321e+13,0,318,318,0,21,21,0,297,297,0,53,"Pattern cycling"
46,2,1.70023e+14,1.70023e+14,0,392,392,0,72,72,0,320,320,0,53,"Pattern cycling"
46,3,5.81606e+11,5.81606e+11,0,488,488,0,7,7,0,481,481,0,53,"Pattern cycling"
47,0,8.37731e+15,8.37731e+15,0,354,354,0,35,35,0,319,319,0,120,"Pattern cycling"
47,1,7.92008e+16,7.92008e+16,0,412,412,0,32,32,0,380,380,0,120,"Pattern cycling"
47,2,1.79195e+15,1.79195e+15,0,411,411,0,68,68,0,343,343,0,120,"Pattern cycling"
47,3,1.27953e+12,1.27953e+12,0,521,521,0,26,26,0,495,495,0,120,"Pattern cycling"
48,0,1.32668e+16,1.32668e+16,0,373,373,0,50,50,0,323,323,0,78,"Pattern cycling"
48,1,1.88356e+14,1.88356e+14,0,369,369,0,48,48,0,321,321,0,78,"Pattern cycling"
48,2,3.48178e+14,3.48178e+14,0,451,451,0,124,124,0,327,327,0,78,"Pattern cycling"
48,3,2.8332e+13,2.8332e+13,0,552,552,0,2,2,0,550,550,0,78,"Pattern cycling"
49,0,2.09288e+17,2.09288e+17,0,377,377,0,30,30,0,347,347,0,81,"Pattern cycling"
49,1,2.83701e+14,2.83701e+14,0,344,344,0,19,19,0,325,325,0,81,"Pattern cycling"
49,2,2.84463e+16,2.84463e+16,0,382,382,0,12,12,0,370,370,0,81,"Pattern cycling"
49,3,9.71769e+12,9.71769e+12,0,539,539,0,8,8,0,531,531,0,81,"Pattern cycling"
50,0,1.66955e+16,1.66955e+16,0,357,357,0,32,32,0,325,325,0,34,"Pattern cycling"
50,1,2.19332e+13,2.19332e+13,0,409,409,0,109,109,0,300,300,0,34,"Pattern cycling"
50,2,1.1258e+12,1.1258e+12,0,390,390,0,119,119,0,271,271,0,34,"Pattern cycling"
50,3,6.8866e+11,6.8866e+11,0,488,488,0,4,4,0,484,484,0,34,"Pattern cycling"
51,0,1.34745e+12,1.34745e+12,0,315,315,0,72,72,0,243,243,0,30,"Pattern cycling"
51,1,7.47448e+11,7.47448e+11,0,305,305,0,38,38,0,267,267,0,30,"Pattern cycling"
51,2,4.96249e+11,4.96249e+11,0,311,311,0,48,48,0,263,263,0,30,"Pattern cycling"
51,3,2559620,2559620,0,280,280,0,18,18,0,262,262,0,30,"Pattern cycling"
52,0,5.95722e+14,5.95722e+14,0,308,308,0,12,12,0,296,296,0,90,"Pattern cycling"
52,1,8.2804e+11,8.2804e+11,0,275,275,0,7,7,0,268,268,0,90,"Pattern cycling"
52,2,8.75053e+14,8.75053e+14,0,342,342,0,6,6,0,336,336,0,90,"Pattern cycling"
52,3,4.97582e+13,4.97582e+13,0,564,564,0,4,4,0,560,560,0,90,"Pattern cycling"
53,0,9.28884e+18,9.28884e+18,0,452,452,0,72,72,0,380,380,0,62,"Set pattern"
53,1,2.55402e+12,2.55402e+12,0,410,410,0,131,131,0,279,279,0,62,"Set pattern"
53,2,3.30357e+13,3.30357e+13,0,418,418,0,114,114,0,304,304,0,62,"Set pattern"
53,3,5.5332e+12,5.5332e+12,0,521,521,0,0,0,0,521,521,0,62,"Set pattern"
54,0,2.31161e+21,2.31161e+21,0,428,428,0,0,0,0,428,428,0,187,"Pattern cycling"
54,1,6.17258e+21,6.17258e+21,0,490,490,0,0,0,0,490,490,0,187,"Pattern cycling"
54,2,1.26404e+22,1.26404e+22,0,497,497,0,0,0,0,497,497,0,187,"Pattern cycling"
54,3,3.61852e+16,3.61852e+16,0,677,677,0,0,0,0,677,677,0,187,"Pattern cycling"
55,0,5.20831e+19,5.20831e+19,0,399,399,0,4,4,0,395,395,0,179,"Pattern cycling"
55,1,2.10917e+22,2.10917e+22,0,510,510,0,8,8,0,502,502,0,179,"Pattern cycling"
55,2,3.1683e+20,3.1683e+20,0,488,488,0,27,27,0,461,461,0,179,"Pattern cycling"
55,3,2.2224e+19,2.2224e+19,0,819,819,0,28,28,0,791,791,0,179,"Pattern cycling"
56,0,2.98916e+14,2.98916e+14,0,296,296,0,6,6,0,290,290,0,82,"Pattern cycling"
56,1,7.11096e+12,7.11096e+12,0,291,291,0,2,2,0,289,289,0,82,"Pattern cycling"
56,2,7.13007e+14,7.13007e+14,0,340,340,0,6,6,0,334,334,0,82,"Pattern cycling"
56,3,2161720,2161720,0,261,261,0,2,2,0,259,259,0,82,"Pattern cycling"
57,0,3.00079e+13,3.00079e+13,0,313,313,0,43,43,0,270,270,0,66,"Pattern cycling"
57,1,5.51233e+13,5.51233e+13,0,331,331,0,22,22,0,309,309,0,66,"Pattern cycling"
57,2,4.97582e+13,4.97582e+13,0,349,349,0,41,41,0,308,308,0,66,"Pattern cycling"
57,3,2.9398e+10,2.9398e+10,0,451,451,0,23,23,0,428,428,0,66,"Pattern cycling"
58,0,2.92033e+20,2.92033e+20,0,445,445,0,35,35,0,410,410,0,155,"Pattern cycling"
58,1,7.53489e+17,7.53489e+17,0,606,606,0,204,204,0,402,402,0,155,"Pattern cycling"
58,2,2.20512e+17,2.20512e+17,0,509,509,0,119,119,0,390,390,0,155,"Pattern cycling"
58,3,4.25697e+15,4.25697e+15,0,699,699,0,60,60,0,639,639,0,155,"Pattern cycling"
59,0,2.35692e+16,2.35692e+16,0,342,342,0,14,14,0,328,328,0,68,"Pattern cycling"
59,1,6.10668e+13,6.10668e+13,0,317,317,0,7,7,0,310,310,0,68,"Pattern cycling"
59,2,3.30357e+13,3.30357e+13,0,329,329,0,25,25,0,304,304,0,68,"Pattern cycling"
59,3,8.15419e+11,8.15419e+11,0,505,505,0,18,18,0,487,487,0,68,"Pattern cycling"
60,0,1.65021e+19,1.65021e+19,0,400,400,0,15,15,0,385,385,0,177,"Pattern cycling"
60,1,2.33032e+20,2.33032e+20,0,488,488,0,30,30,0,458,458,0,177,"Pattern cycling"
60,2,2.58158e+20,2.58158e+20,0,482,482,0,23,23,0,459,459,0,177,"Pattern cycling"
60,3,2004.12,2004.12,0,135,135,0,0,0,0,135,135,0,177,"Pattern cycling"
61,0,2.65429e+15,2.65429e+15,0,311,311,0,2,2,0,309,309,0,103,"Pattern cycling"
61,1,9.22257e+15,9.22257e+15,0,361,361,0,2,2,0,359,359,0,103,"Pattern cycling"
61,2,6.43611e+14,6.43611e+14,0,350,350,0,17,17,0,333,333,0,103,"Pattern cycling"
61,3,26266400000,26266400000,0,427,427,0,1,1,0,426,426,0,103,"Pattern cycling"
62,0,4.12268e+20,4.12268e+20,0,470,470,0,57,57,0,413,413,0,152,"Pattern cycling"
62,1,3.32135e+17,3.32135e+17,0,457,457,0,63,63,0,394,394,0,152,"Pattern cycling"
62,2,6.13954e+17,6.13954e+17,0,491,491,0,91,91,0,400,400,0,152,"Pattern cycling"
62,3,1.3891e+16,1.3891e+16,0,664,664,0,4,4,0,660,660,0,152,"Pattern cycling"
63,0,1.18724e+15,1.18724e+15,0,348,348,0,46,46,0,302,302,0,72,"Pattern cycling"
63,1,1.01896e+14,1.01896e+14,0,353,353,0,38,38,0,315,315,0,72,"Pattern cycling"
63,2,9.19786e+13,9.19786e+13,0,365,365,0,51,51,0,314,314,0,72,"Pattern cycling"
63,3,1.08763e+13,1.08763e+13,0,549,549,0,16,16,0,533,533,0,72,"Pattern cycling"
64,0,1.1554e+22,1.1554e+22,0,492,492,0,50,50,0,442,442,0,169,"Pattern cycling"
64,1,1.32509e+19,1.32509e+19,0,446,446,0,16,16,0,430,430,0,169,"Pattern cycling"
64,2,1.08261e+21,1.08261e+21,0,499,499,0,26,26,0,473,473,0,169,"Pattern cycling"
64,3,2.56432e+15,2.56432e+15,0,630,630,0,0,0,0,630,630,0,169,"Pattern cycling"
65,0,3.74709e+15,3.74709e+15,0,335,335,0,23,23,0,312,312,0,100,"Pattern cycling"
65,1,1.318e+15,1.318e+15,0,352,352,0,12,12,0,340,340,0,100,"Pattern cycling"
65,2,1.61321e+13,1.61321e+13,0,311,311,0,14,14,0,297,297,0,100,"Pattern cycling"
65,3,95929100000,95929100000,0,449,449,0,0,0,0,449,449,0,100,"Pattern cycling"
66,0,4.1872e+16,4.1872e+16,0,364,364,0,31,31,0,333,333,0,113,"Pattern cycling"
66,1,1.19292e+17,1.19292e+17,0,432,432,0,48,48,0,384,384,0,113,"Pattern cycling"
66,2,3.6696e+15,3.6696e+15,0,403,403,0,53,53,0,350,350,0,113,"Pattern cycling"
66,3,2.67805e+13,2.67805e+13,0,554,554,0,5,5,0,549,549,0,113,"Pattern cycling"
67,0,1.20582e+11,1.20582e+11,0,238,238,0,16,16,0,222,222,0,4,"Pattern cycling"
67,1,3285890000,3285890000,0,241,241,0,27,27,0,214,214,0,4,"Pattern cycling"
67,2,4467490000,4467490000,0,239,239,0,22,22,0,217,217,0,4,"Pattern cycling"
67,3,2864790,2864790,0,264,264,0,0,0,0,264,264,0,4,"Pattern cycling"
68,0,8.21624e+20,8.21624e+20,0,429,429,0,10,10,0,419,419,0,122,"Pattern cycling"
68,1,1.18972e+15,1.18972e+15,0,354,354,0,15,15,0,339,339,0,122,"Pattern cycling"
68,2,6.12309e+15,6.12309e+15,0,390,390,0,35,35,0,355,355,0,122,"Pattern cycling"
68,3,307018000,307018000,0,514,514,0,167,167,0,347,347,0,122,"Pattern cycling"
69,0,2.61338e+19,2.61338e+19,0,490,490,0,101,101,0,389,389,0,178,"Pattern cycling"
69,1,8.82125e+20,8.82125e+20,0,566,566,0,95,95,0,471,471,0,178,"Pattern cycling"
69,2,2.58158e+20,2.58158e+20,0,614,614,0,155,155,0,459,459,0,178,"Pattern cycling"
69,3,9.12637e+11,9.12637e+11,0,501,501,0,12,12,0,489,489,0,178,"Pattern cycling"
70,0,1.51745e+11,1.51745e+11,0,266,266,0,42,42,0,224,224,0,25,"Pattern cycling"
70,1,4.04351e+11,4.04351e+11,0,301,301,0,40,40,0,261,261,0,25,"Pattern cycling"
70,2,1.4523e+11,1.4523e+11,0,281,281,0,30,30,0,251,251,0,25,"Pattern cycling"
70,3,1.51505e+12,1.51505e+12,0,540,540,0,42,42,0,498,498,0,25,"Pattern cycling"
71,0,2.06062e+21,2.06062e+21,0,450,450,0,23,23,0,427,427,0,184,"Pattern cycling"
71,1,3.88837e+20,3.88837e+20,0,499,499,0,36,36,0,463,463,0,184,"Pattern cycling"
71,2,3.33922e+21,3.33922e+21,0,524,524,0,40,40,0,484,484,0,184,"Pattern cycling"
71,3,68422400000,68422400000,0,494,494,0,51,51,0,443,443,0,184,"Pattern cycling"
72,0,1.33703e+14,1.33703e+14,0,307,307,0,24,24,0,283,283,0,76,"Pattern cycling"
72,1,1.70023e+14,1.70023e+14,0,350,350,0,30,30,0,320,320,0,76,"Pattern cycling"
72,2,5.25833e+16,5.25833e+16,0,426,426,0,50,50,0,376,376,0,76,"Pattern cycling"
72,3,2.02081e+13,2.02081e+13,0,556,556,0,12,12,0,544,544,0,76,"Pattern cycling"
73,0,3.34025e+15,3.34025e+15,0,328,328,0,17,17,0,311,311,0,131,"Pattern cycling"
73,1,5.25833e+16,5.25833e+16,0,433,433,0,57,57,0,376,376,0,131,"Pattern cycling"
73,2,3.86756e+16,3.86756e+16,0,429,429,0,56,56,0,373,373,0,131,"Pattern cycling"
73,3,3.99794e+14,3.99794e+14,0,609,609,0,12,12,0,597,597,0,131,"Pattern cycling"
74,0,9.36125e+16,9.36125e+16,0,349,349,0,9,9,0,340,340,0,110,"Pattern cycling"
74,1,3.31245e+15,3.31245e+15,0,357,357,0,8,8,0,349,349,0,110,"Pattern cycling"
74,2,4.5036e+15,4.5036e+15,0,377,377,0,25,25,0,352,352,0,110,"Pattern cycling"
74,3,31101200000,31101200000,0,435,435,0,6,6,0,429,429,0,110,"Pattern cycling"
75,0,9.50777e+12,9.50777e+12,0,260,260,0,0,0,0,260,260,0,44,"Pattern cycling"
75,1,4.06527e+15,4.06527e+15,0,351,351,0,0,0,0,351,351,0,44,"Pattern cycling"
75,2,1.53064e+12,1.53064e+12,0,274,274,0,0,0,0,274,274,0,44,"Pattern cycling"
75,3,539202000,539202000,0,357,357,0,0,0,0,357,357,0,44,"Pattern cycling"
76,0,3.32731e+16,3.32731e+16,0,344,344,0,13,13,0,331,331,0,91,"Pattern cycling"
76,1,3.1429e+14,3.1429e+14,0,340,340,0,14,14,0,326,326,0,91,"Pattern cycling"
76,2,6.43611e+14,6.43611e+14,0,336,336,0,3,3,0,333,333,0,91,"Pattern cycling"
76,3,10667500000,10667500000,0,444,444,0,34,34,0,410,410,0,91,"Pattern cycling"
77,0,7.32416e+20,7.32416e+20,0,515,515,0,97,97,0,418,418,0,108,"Pattern cycling"
77,1,2.99005e+15,2.99005e+15,0,478,478,0,130,130,0,348,348,0,108,"Pattern cycling"
77,2,1.79195e+15,1.79195e+15,0,453,453,0,110,110,0,343,343,0,108,"Pattern cycling"
77,3,5.60516e+14,5.60516e+14,0,603,603,0,0,0,0,603,603,0,108,"Pattern cycling"
78,0,1.85841e+18,1.85841e+18,0,367,367,0,1,1,0,366,366,0,145,"Pattern cycling"
78,1,3.32135e+17,3.32135e+17,0,412,412,0,18,18,0,394,394,0,145,"Pattern cycling"
78,2,9.2722e+19,9.2722e+19,0,451,451,0,2,2,0,449,449,0,145,"Pattern cycling"
78,3,21757400,21757400,0,308,308,0,8,8,0,300,300,0,145,"Pattern cycling"
79,0,3.28877e+19,3.28877e+19,0,410,410,0,19,19,0,391,391,0,147,"Reactive meandering"
79,1,3.67946e+17,3.67946e+17,0,410,410,0,15,15,0,395,395,0,147,"Reactive meandering"
79,2,2.99005e+15,2.99005e+15,0,364,364,0,16,16,0,348,348,0,147,"Reactive meandering"
79,3,4.88926e+19,4.88926e+19,0,830,830,0,25,25,0,805,805,0,147,"Reactive meandering"
80,0,3.64662e+22,3.64662e+22,0,513,513,0,61,61,0,452,452,0,65,"Set pattern"
80,1,1.18972e+15,1.18972e+15,0,469,469,0,130,130,0,339,339,0,65,"Set pattern"
80,2,1.31447e+13,1.31447e+13,0,446,446,0,151,151,0,295,295,0,65,"Set pattern"
80,3,4.44577e+13,4.44577e+13,0,562,562,0,4,4,0,558,558,0,65,"Set pattern"
81,0,3.34025e+15,3.34025e+15,0,333,333,0,22,22,0,311,311,0,115,"Pattern cycling"
81,1,4.06527e+15,4.06527e+15,0,375,375,0,24,24,0,351,351,0,115,"Pattern cycling"
81,2,4.5036e+15,4.5036e+15,0,371,371,0,19,19,0,352,352,0,115,"Pattern cycling"
81,3,8.42193e+16,8.42193e+16,0,701,701,0,9,9,0,692,692,0,115,"Pattern cycling"
82,0,4.69721e+16,4.69721e+16,0,496,496,0,162,162,0,334,334,0,137,"Pattern cycling"
82,1,3.49113e+16,3.49113e+16,0,450,450,0,78,78,0,372,372,0,137,"Pattern cycling"
82,2,9.22257e+15,9.22257e+15,0,500,500,0,141,141,0,359,359,0,137,"Pattern cycling"
82,3,1.72887e+15,1.72887e+15,0,623,623,0,0,0,0,623,623,0,137,"Pattern cycling"
83,0,3.64662e+22,3.64662e+22,0,470,470,0,18,18,0,452,452,0,190,"Pattern cycling"
83,1,2.21699e+21,2.21699e+21,0,498,498,0,18,18,0,480,480,0,190,"Pattern cycling"
83,2,1.20579e+25,1.20579e+25,0,582,582,0,18,18,0,564,564,0,190,"Pattern cycling"
83,3,8.01233e+17,8.01233e+17,0,750,750,0,18,18,0,732,732,0,190,"Pattern cycling"
84,0,1.8875e+14,1.8875e+14,0,313,313,0,27,27,0,286,286,0,48,"Pattern cycling"
84,1,2.19332e+13,2.19332e+13,0,322,322,0,22,22,0,300,300,0,48,"Pattern cycling"
84,2,1.18653e+13,1.18653e+13,0,313,313,0,19,19,0,294,294,0,48,"Pattern cycling"
84,3,1861410000,1861410000,0,381,381,0,2,2,0,379,379,0,48,"Pattern cycling"
85,0,1.16894e+19,1.16894e+19,0,382,382,0,0,0,0,382,382,0,140,"Pattern cycling"
85,1,9.72008e+16,9.72008e+16,0,382,382,0,0,0,0,382,382,0,140,"Pattern cycling"
85,2,4.08715e+19,4.08715e+19,0,461,461,0,20,20,0,441,441,0,140,"Pattern cycling"
85,3,2204040000,2204040000,0,382,382,0,0,0,0,382,382,0,140,"Pattern cycling"
86,0,7.49678e+14,7.49678e+14,0,313,313,0,15,15,0,298,298,0,92,"Pattern cycling"
86,1,3.6696e+15,3.6696e+15,0,371,371,0,21,21,0,350,350,0,92,"Pattern cycling"
86,2,1.78715e+13,1.78715e+13,0,384,384,0,86,86,0,298,298,0,92,"Pattern cycling"
86,3,5.81606e+11,5.81606e+11,0,500,500,0,19,19,0,481,481,0,92,"Pattern cycling"
87,0,8.50843e+11,8.50843e+11,0,248,248,0,9,9,0,239,239,0,1,"Pattern cycling"
87,1,44555200,44555200,0,192,192,0,20,20,0,172,172,0,1,"Pattern cycling"
87,2,54681300,54681300,0,218,218,0,44,44,0,174,174,0,1,"Pattern cycling"
87,3,25762200,25762200,0,310,310,0,7,7,0,303,303,0,1,"Pattern cycling"
88,0,2.93169e+19,2.93169e+19,0,430,430,0,40,40,0,390,390,0,160,"Pattern cycling"
88,1,1.39283e+18,1.39283e+18,0,442,442,0,34,34,0,408,408,0,160,"Pattern cycling"
88,2,2.57467e+18,2.57467e+18,0,442,442,0,28,28,0,414,414,0,160,"Pattern cycling"
88,3,3.2903e+10,3.2903e+10,0,464,464,0,34,34,0,430,430,0,160,"Pattern cycling"
89,0,7.52595e+13,7.52595e+13,0,299,299,0,21,21,0,278,278,0,67,"Pattern cycling"
89,1,1.70023e+14,1.70023e+14,0,340,340,0,20,20,0,320,320,0,67,"Pattern cycling"
89,2,5.51233e+13,5.51233e+13,0,343,343,0,34,34,0,309,309,0,67,"Pattern cycling"
89,3,2.37736e+12,2.37736e+12,0,523,523,0,17,17,0,506,506,0,67,"Pattern cycling"
90,0,2.68538e+12,2.68538e+12,0,257,257,0,8,8,0,249,249,0,37,"Pattern cycling"
90,1,2.08106e+12,2.08106e+12,0,346,346,0,69,69,0,277,277,0,37,"Pattern cycling"
90,2,1.70023e+14,1.70023e+14,0,349,349,0,29,29,0,320,320,0,37,"Pattern cycling"
90,3,23468400000,23468400000,0,450,450,0,26,26,0,424,424,0,37,"Pattern cycling"
91,0,4.23626e+13,4.23626e+13,0,273,273,0,0,0,0,273,273,0,27,"Pattern cycling"
91,1,6.09032e+11,6.09032e+11,0,296,296,0,31,31,0,265,265,0,27,"Pattern cycling"
91,2,4.96249e+11,4.96249e+11,0,294,294,0,31,31,0,263,263,0,27,"Pattern cycling"
91,3,45244800,45244800,0,320,320,0,7,7,0,313,313,0,27,"Pattern cycling"
92,0,1.67604e+15,1.67604e+15,0,327,327,0,22,22,0,305,305,0,70,"Pattern cycling"
92,1,7.49456e+13,7.49456e+13,0,381,381,0,69,69,0,312,312,0,70,"Pattern cycling"
92,2,5.24424e+14,5.24424e+14,0,419,419,0,88,88,0,331,331,0,70,"Pattern cycling"
92,3,3144.79,3144.79,0,143,143,0,0,0,0,143,143,0,70,"Pattern cycling"
93,0,3.68935e+19,3.68935e+19,0,399,399,0,7,7,0,392,392,0,170,"Pattern cycling"
93,1,1.62625e+19,1.62625e+19,0,542,542,0,110,110,0,432,432,0,170,"Pattern cycling"
93,2,3.1683e+20,3.1683e+20,0,484,484,0,23,23,0,461,461,0,170,"Pattern cycling"
93,3,5.1392e+18,5.1392e+18,0,779,779,0,14,14,0,765,765,0,170,"Pattern cycling"
94,0,1.31132e+19,1.31132e+19,0,412,412,0,29,29,0,383,383,0,191,"Pattern cycling"
94,1,7.20701e+22,7.20701e+22,0,527,527,0,13,13,0,514,514,0,191,"Pattern cycling"
94,2,1.54301e+18,1.54301e+18,0,460,460,0,51,51,0,409,409,0,191,"Pattern cycling"
94,3,4.77326e+24,4.77326e+24,0,1021,1021,0,12,12,0,1009,1009,0,191,"Pattern cycling"
95,0,2.12564e+13,2.12564e+13,0,282,282,0,15,15,0,267,267,0,55,"Pattern cycling"
95,1,4.05438e+13,4.05438e+13,0,358,358,0,52,52,0,306,306,0,55,"Pattern cycling"
95,2,1.61321e+13,1.61321e+13,0,349,349,0,52,52,0,297,297,0,55,"Pattern cycling"
95,3,81016700000,81016700000,0,459,459,0,13,13,0,446,446,0,55,"Pattern cycling"
96,0,4.21985e+14,4.21985e+14,0,293,293,0,0,0,0,293,293,0,86,"Pattern cycling"
96,1,1.07393e+15,1.07393e+15,0,346,346,0,8,8,0,338,338,0,86,"Pattern cycling"
96,2,2.56089e+14,2.56089e+14,0,354,354,0,30,30,0,324,324,0,86,"Pattern cycling"
96,3,2043340,2043340,0,286,286,0,28,28,0,258,258,0,86,"Pattern cycling"
97,0,1.67604e+15,1.67604e+15,0,357,357,0,52,52,0,305,305,0,77,"Pattern cycling"
97,1,1.70023e+14,1.70023e+14,0,342,342,0,22,22,0,320,320,0,77,"Pattern cycling"
97,2,4.49153e+13,4.49153e+13,0,365,365,0,58,58,0,307,307,0,77,"Pattern cycling"
97,3,1.79392e+12,1.79392e+12,0,507,507,0,6,6,0,501,501,0,77,"Pattern cycling"
98,0,2.07669e+19,2.07669e+19,0,388,388,0,1,1,0,387,387,0,161,"Pattern cycling"
98,1,2.56777e+16,2.56777e+16,0,370,370,0,1,1,0,369,369,0,161,"Pattern cycling"
98,2,2.57467e+18,2.57467e+18,0,416,416,0,2,2,0,414,414,0,161,"Pattern cycling"
98,3,3.97219e+13,3.97219e+13,0,559,559,0,3,3,0,556,556,0,161,"Pattern cycling"
99,0,4.75224e+13,4.75224e+13,0,292,292,0,18,18,0,274,274,0,109,"Pattern cycling"
99,1,1.2539e+16,1.2539e+16,0,408,408,0,46,46,0,362,362,0,109,"Pattern cycling"
99,2,2.99005e+15,2.99005e+15,0,401,401,0,53,53,0,348,348,0,109,"Pattern cycling"
99,3,1.43208e+12,1.43208e+12,0,499,499,0,2,2,0,497,497,0,109,"Pattern cycling"
100,0,1.47676e+18,1.47676e+18,0,399,399,0,35,35,0,364,364,0,116,"Pattern cycling"
100,1,1.79195e+15,1.79195e+15,0,344,344,0,1,1,0,343,343,0,116,"Pattern cycling"
100,2,4.06527e+15,4.06527e+15,0,419,419,0,68,68,0,351,351,0,116,"Pattern cycling"
100,3,1.29617e+14,1.29617e+14,0,584,584,0,7,7,0,577,577,0,116,"Pattern cycling"
101,0,5.24891e+17,5.24891e+17,0,433,433,0,78,78,0,355,355,0,143,"Pattern cycling"
101,1,1.62189e+17,1.62189e+17,0,430,430,0,43,43,0,387,387,0,143,"Pattern cycling"
101,2,9.24735e+17,9.24735e+17,0,445,445,0,41,41,0,404,404,0,143,"Pattern cycling"
101,3,6.93124e+12,6.93124e+12,0,527,527,0,2,2,0,525,525,0,143,"Pattern cycling"
102,0,8.47546e+12,8.47546e+12,0,263,263,0,4,4,0,259,259,0,51,"Pattern cycling"
102,1,2.83701e+14,2.83701e+14,0,337,337,0,12,12,0,325,325,0,51,"Pattern cycling"
102,2,1.4562e+13,1.4562e+13,0,300,300,0,4,4,0,296,296,0,51,"Pattern cycling"
102,3,539202000,539202000,0,357,357,0,0,0,0,357,357,0,51,"Pattern cycling"
103,0,1.68911e+13,1.68911e+13,0,281,281,0,16,16,0,265,265,0,80,"Pattern cycling"
103,1,2.56089e+14,2.56089e+14,0,343,343,0,19,19,0,324,324,0,80,"Pattern cycling"
103,2,4.28457e+16,4.28457e+16,0,386,386,0,12,12,0,374,374,0,80,"Pattern cycling"
103,3,8515830000,8515830000,0,417,417,0,11,11,0,406,406,0,80,"Pattern cycling"
104,0,9.21699e+20,9.21699e+20,0,455,455,0,35,35,0,420,420,0,194,"Pattern cycling"
104,1,9.32209e+23,9.32209e+23,0,570,570,0,31,31,0,539,539,0,194,"Pattern cycling"
104,2,4.09813e+21,4.09813e+21,0,564,564,0,78,78,0,486,486,0,194,"Pattern cycling"
104,3,1.04335e+24,1.04335e+24,0,983,983,0,1,1,0,982,982,0,194,"Pattern cycling"
105,0,2.08477e+18,2.08477e+18,0,374,374,0,7,7,0,367,367,0,142,"Pattern cycling"
105,1,7.5147e+15,7.5147e+15,0,364,364,0,7,7,0,357,357,0,142,"Pattern cycling"
105,2,1.19292e+17,1.19292e+17,0,428,428,0,44,44,0,384,384,0,142,"Pattern cycling"
105,3,1.51505e+12,1.51505e+12,0,508,508,0,10,10,0,498,498,0,142,"Pattern cycling"
106,0,8.4099e+14,8.4099e+14,0,416,416,0,117,117,0,299,299,0,138,"Pattern cycling"
106,1,2.09788e+18,2.09788e+18,0,426,426,0,14,14,0,412,412,0,138,"Pattern cycling"
106,2,5.25833e+16,5.25833e+16,0,396,396,0,20,20,0,376,376,0,138,"Pattern cycling"
106,3,5.85376e+12,5.85376e+12,0,610,610,0,88,88,0,522,522,0,138,"Pattern cycling"
107,0,2.06062e+21,2.06062e+21,0,470,470,0,43,43,0,427,427,0,185,"Set pattern"
107,1,5.30083e+22,5.30083e+22,0,511,511,0,0,0,0,511,511,0,185,"Set pattern"
107,2,4.4795e+11,4.4795e+11,0,389,389,0,127,127,0,262,262,0,185,"Set pattern"
107,3,3.15057e+12,3.15057e+12,0,511,511,0,0,0,0,511,511,0,185,"Set pattern"
108,0,1.48251e+17,1.48251e+17,0,374,374,0,30,30,0,344,344,0,134,"Pattern cycling"
108,1,2.56777e+16,2.56777e+16,0,406,406,0,37,37,0,369,369,0,134,"Pattern cycling"
108,2,3.49113e+16,3.49113e+16,0,439,439,0,67,67,0,372,372,0,134,"Pattern cycling"
108,3,2.56432e+15,2.56432e+15,0,639,639,0,9,9,0,630,630,0,134,"Pattern cycling"
109,0,2.92033e+20,2.92033e+20,0,452,452,0,42,42,0,410,410,0,127,"Pattern cycling"
109,1,1.54716e+20,1.54716e+20,0,468,468,0,14,14,0,454,454,0,127,"Pattern cycling"
109,2,1.7048e+16,1.7048e+16,0,384,384,0,19,19,0,365,365,0,127,"Pattern cycling"
109,3,1.27129e+11,1.27129e+11,0,468,468,0,14,14,0,454,454,0,127,"Pattern cycling"
110,0,1.67604e+15,1.67604e+15,0,359,359,0,54,54,0,305,305,0,101,"Pattern cycling"
110,1,2.84463e+16,2.84463e+16,0,437,437,0,67,67,0,370,370,0,101,"Pattern cycling"
110,2,1.18972e+15,1.18972e+15,0,406,406,0,67,67,0,339,339,0,101,"Pattern cycling"
110,3,16102.5,16102.5,0,179,179,0,7,7,0,172,172,0,101,"Pattern cycling"
111,0,2.34779e+17,2.34779e+17,0,384,384,0,36,36,0,348,348,0,128,"Pattern cycling"
111,1,1.7048e+16,1.7048e+16,0,371,371,0,6,6,0,365,365,0,128,"Pattern cycling"
111,2,8.86872e+24,8.86872e+24,0,623,623,0,62,62,0,561,561,0,128,"Pattern cycling"
111,3,3.19155e+14,3.19155e+14,0,629,629,0,36,36,0,593,593,0,128,"Pattern cycling"
112,0,1.61849e+24,1.61849e+24,0,491,491,0,6,6,0,485,485,0,174,"Pattern cycling"
112,1,1.62625e+19,1.62625e+19,0,445,445,0,13,13,0,432,432,0,174,"Pattern cycling"
112,2,6.8198e+19,6.8198e+19,0,455,455,0,9,9,0,446,446,0,174,"Pattern cycling"
112,3,1.21168e+21,1.21168e+21,0,881,881,0,19,19,0,862,862,0,174,"Pattern cycling"
113,0,7.52595e+13,7.52595e+13,0,312,312,0,34,34,0,278,278,0,10,"Pattern cycling"
113,1,16911300000,16911300000,0,252,252,0,22,22,0,230,230,0,10,"Pattern cycling"
113,2,783552000,783552000,0,241,241,0,41,41,0,200,200,0,10,"Pattern cycling"
113,3,2204040000,2204040000,0,409,409,0,27,27,0,382,382,0,10,"Pattern cycling"
114,0,1.88018e+15,1.88018e+15,0,322,322,0,16,16,0,306,306,0,104,"Pattern cycling"
114,1,9.22257e+15,9.22257e+15,0,366,366,0,7,7,0,359,359,0,104,"Pattern cycling"
114,2,5.80969e+14,5.80969e+14,0,354,354,0,22,22,0,332,332,0,104,"Pattern cycling"
114,3,4.47459e+14,4.47459e+14,0,606,606,0,7,7,0,599,599,0,104,"Pattern cycling"
115,0,3.71811e+17,3.71811e+17,0,361,361,0,9,9,0,352,352,0,130,"Reactive meandering"
115,1,9.77239e+20,9.77239e+20,0,481,481,0,9,9,0,472,472,0,130,"Reactive meandering"
115,2,2.09226e+16,2.09226e+16,0,376,376,0,9,9,0,367,367,0,130,"Reactive meandering"
115,3,2.66081e+12,2.66081e+12,0,517,517,0,9,9,0,508,508,0,130,"Reactive meandering"
116,0,5.84268e+19,5.84268e+19,0,472,472,0,76,76,0,396,396,0,50,"Set pattern"
116,1,3.48178e+14,3.48178e+14,0,446,446,0,119,119,0,327,327,0,50,"Set pattern"
116,2,7.11096e+12,7.11096e+12,0,423,423,0,134,134,0,289,289,0,50,"Set pattern"
116,3,1.44136e+13,1.44136e+13,0,543,543,0,5,5,0,538,538,0,50,"Set pattern"
117,0,5.88823e+17,5.88823e+17,0,356,356,0,0,0,0,356,356,0,87,"Pattern cycling"
117,1,4.73383e+14,4.73383e+14,0,346,346,0,16,16,0,330,330,0,87,"Pattern cycling"
117,2,4.27309e+14,4.27309e+14,0,358,358,0,29,29,0,329,329,0,87,"Pattern cycling"
117,3,1.08062e+12,1.08062e+12,0,492,492,0,0,0,0,492,492,0,87,"Pattern cycling"
118,0,12105100000,12105100000,0,202,202,0,0,0,0,202,202,0,2,"Set pattern"
118,1,961632000,961632000,0,202,202,0,0,0,0,202,202,0,2,"Set pattern"
118,2,961632000,961632000,0,202,202,0,0,0,0,202,202,0,2,"Set pattern"
118,3,87227.8,87227.8,0,202,202,0,0,0,0,202,202,0,2,"Set pattern"
119,0,2.27599e+25,2.27599e+25,0,528,528,0,20,20,0,508,508,0,199,"Pattern cycling"
119,1,2.12621e+28,2.12621e+28,0,637,637,0,0,0,0,637,637,0,199,"Pattern cycling"
119,2,8.46006e+27,8.46006e+27,0,650,650,0,22,22,0,628,628,0,199,"Pattern cycling"
119,3,16.7084,16.7084,0,50,50,0,0,0,0,50,50,0,199,"Pattern cycling"
120,0,1.14202e+25,1.14202e+25,0,624,624,0,122,122,0,502,502,0,168,"Pattern cycling"
120,1,1.19612e+19,1.19612e+19,0,432,432,0,3,3,0,429,429,0,168,"Pattern cycling"
120,2,9.7462e+18,9.7462e+18,0,519,519,0,92,92,0,427,427,0,168,"Pattern cycling"
120,3,9.61053e+19,9.61053e+19,0,820,820,0,3,3,0,817,817,0,168,"Pattern cycling"
121,0,5.86541e+18,5.86541e+18,0,413,413,0,37,37,0,376,376,0,47,"Set pattern"
121,1,1.07105e+13,1.07105e+13,0,381,381,0,88,88,0,293,293,0,47,"Set pattern"
121,2,4.04351e+11,4.04351e+11,0,361,361,0,100,100,0,261,261,0,47,"Set pattern"
121,3,95929100000,95929100000,0,449,449,0,0,0,0,449,449,0,47,"Set pattern"
122,0,1.48827e+16,1.48827e+16,0,362,362,0,38,38,0,324,324,0,114,"Pattern cycling"
122,1,2.84463e+16,2.84463e+16,0,424,424,0,54,54,0,370,370,0,114,"Pattern cycling"
122,2,3.6696e+15,3.6696e+15,0,402,402,0,52,52,0,350,350,0,114,"Pattern cycling"
122,3,2043340,2043340,0,258,258,0,0,0,0,258,258,0,114,"Pattern cycling"
123,0,4.1872e+16,4.1872e+16,0,374,374,0,41,41,0,333,333,0,84,"Pattern cycling"
123,1,4.27309e+14,4.27309e+14,0,365,365,0,36,36,0,329,329,0,84,"Pattern cycling"
123,2,3.48178e+14,3.48178e+14,0,389,389,0,62,62,0,327,327,0,84,"Pattern cycling"
123,3,9.78068e+13,9.78068e+13,0,611,611,0,39,39,0,572,572,0,84,"Pattern cycling"
124,0,4.67901e+17,4.67901e+17,0,358,358,0,4,4,0,354,354,0,151,"Pattern cycling"
124,1,2.44945e+19,2.44945e+19,0,439,439,0,3,3,0,436,436,0,151,"Pattern cycling"
124,2,7.96269e+20,7.96269e+20,0,489,489,0,19,19,0,470,470,0,151,"Pattern cycling"
124,3,2.43961e+16,2.43961e+16,0,672,672,0,2,2,0,670,670,0,151,"Pattern cycling"
125,0,4.50082e+27,4.50082e+27,0,556,556,0,2,2,0,554,554,0,197,"Pattern cycling"
125,1,6.20579e+25,6.20579e+25,0,582,582,0,2,2,0,580,580,0,197,"Pattern cycling"
125,2,5.04303e+23,5.04303e+23,0,535,535,0,2,2,0,533,533,0,197,"Pattern cycling"
125,3,6.35504e+16,6.35504e+16,0,689,689,0,2,2,0,687,687,0,197,"Pattern cycling"
126,0,5.22857e+18,5.22857e+18,0,401,401,0,26,26,0,375,375,0,32,"Set pattern"
126,1,1.06818e+11,1.06818e+11,0,345,345,0,97,97,0,248,248,0,32,"Set pattern"
126,2,6.747e+11,6.747e+11,0,352,352,0,86,86,0,266,266,0,32,"Set pattern"
126,3,15822400000,15822400000,0,421,421,0,4,4,0,417,417,0,32,"Set pattern"
127,0,1.04608e+18,1.04608e+18,0,459,459,0,98,98,0,361,361,0,148,"Pattern cycling"
127,1,3.67946e+17,3.67946e+17,0,478,478,0,83,83,0,395,395,0,148,"Pattern cycling"
127,2,2.20512e+17,2.20512e+17,0,430,430,0,40,40,0,390,390,0,148,"Pattern cycling"
127,3,1.52487e+13,1.52487e+13,0,622,622,0,83,83,0,539,539,0,148,"Pattern cycling"
128,0,1.13319e+27,1.13319e+27,0,622,622,0,80,80,0,542,542,0,198,"Pattern cycling"
128,1,3.19391e+26,3.19391e+26,0,696,696,0,100,100,0,596,596,0,198,"Pattern cycling"
128,2,1.55966e+26,1.55966e+26,0,675,675,0,86,86,0,589,589,0,198,"Pattern cycling"
128,3,1.33255e+27,1.33255e+27,0,1191,1191,0,82,82,0,1109,1109,0,198,"Pattern cycling"
129,0,5.91114e+16,5.91114e+16,0,372,372,0,36,36,0,336,336,0,61,"Pattern cycling"
129,1,2.98204e+13,2.98204e+13,0,356,356,0,53,53,0,303,303,0,61,"Pattern cycling"
129,2,4.72114e+12,4.72114e+12,0,347,347,0,62,62,0,285,285,0,61,"Pattern cycling"
129,3,8049490000,8049490000,0,405,405,0,0,0,0,405,405,0,61,"Pattern cycling"
130,0,4.71548e+15,4.71548e+15,0,408,408,0,94,94,0,314,314,0,156,"Pattern cycling"
130,1,4.30762e+20,4.30762e+20,0,532,532,0,68,68,0,464,464,0,156,"Pattern cycling"
130,2,1.02444e+18,1.02444e+18,0,507,507,0,102,102,0,405,405,0,156,"Pattern cycling"
130,3,8.85246e+15,8.85246e+15,0,679,679,0,27,27,0,652,652,0,156,"Pattern cycling"
131,0,2.36609e+15,2.36609e+15,0,309,309,0,1,1,0,308,308,0,133,"Pattern cycling"
131,1,1.32509e+19,1.32509e+19,0,431,431,0,1,1,0,430,430,0,133,"Pattern cycling"
131,2,4.28457e+16,4.28457e+16,0,375,375,0,1,1,0,374,374,0,133,"Pattern cycling"
131,3,1.2173e+13,1.2173e+13,0,537,537,0,2,2,0,535,535,0,133,"Pattern cycling"
132,0,2.93169e+19,2.93169e+19,0,457,457,0,67,67,0,390,390,0,166,"Pattern cycling"
132,1,3.88837e+20,3.88837e+20,0,632,632,0,169,169,0,463,463,0,166,"Pattern cycling"
132,2,7.16843e+18,7.16843e+18,0,515,515,0,91,91,0,424,424,0,166,"Pattern cycling"
132,3,1.56479e+17,1.56479e+17,0,710,710,0,7,7,0,703,703,0,166,"Pattern cycling"
133,0,8.44261e+13,8.44261e+13,0,280,280,0,1,1,0,279,279,0,69,"Pattern cycling"
133,1,6.76512e+13,6.76512e+13,0,313,313,0,2,2,0,311,311,0,69,"Pattern cycling"
133,2,4.72114e+12,4.72114e+12,0,286,286,0,1,1,0,285,285,0,69,"Pattern cycling"
133,3,43604300000,43604300000,0,437,437,0,2,2,0,435,435,0,69,"Pattern cycling"
134,0,3.00079e+13,3.00079e+13,0,308,308,0,38,38,0,270,270,0,28,"Reactive meandering"
134,1,8.72708e+12,8.72708e+12,0,332,332,0,41,41,0,291,291,0,28,"Reactive meandering"
134,2,6.09032e+11,6.09032e+11,0,313,313,0,48,48,0,265,265,0,28,"Reactive meandering"
134,3,34141000,34141000,0,376,376,0,68,68,0,308,308,0,28,"Reactive meandering"
135,0,6.65692e+15,6.65692e+15,0,477,477,0,160,160,0,317,317,0,98,"Pattern cycling"
135,1,1.25727e+18,1.25727e+18,0,529,529,0,122,122,0,407,407,0,98,"Pattern cycling"
135,2,1.18972e+15,1.18972e+15,0,484,484,0,145,145,0,339,339,0,98,"Pattern cycling"
135,3,1.45071e+14,1.45071e+14,0,579,579,0,0,0,0,579,579,0,98,"Pattern cycling"
136,0,1.16441e+20,1.16441e+20,0,419,419,0,17,17,0,402,402,0,186,"Pattern cycling"
136,1,3.33027e+19,3.33027e+19,0,458,458,0,19,19,0,439,439,0,186,"Pattern cycling"
136,2,2.21699e+21,2.21699e+21,0,524,524,0,44,44,0,480,480,0,186,"Pattern cycling"
136,3,3.73734e+21,3.73734e+21,0,889,889,0,7,7,0,882,882,0,186,"Pattern cycling"
137,0,5.70815e+25,5.70815e+25,0,586,586,0,70,70,0,516,516,0,150,"Pattern cycling"
137,1,1.02444e+18,1.02444e+18,0,578,578,0,173,173,0,405,405,0,150,"Pattern cycling"
137,2,4.5157e+17,4.5157e+17,0,543,543,0,146,146,0,397,397,0,150,"Pattern cycling"
137,3,1.82903e+15,1.82903e+15,0,624,624,0,0,0,0,624,624,0,150,"Pattern cycling"
138,0,1.16894e+19,1.16894e+19,0,422,422,0,40,40,0,382,382,0,162,"Pattern cycling"
138,1,1.318e+15,1.318e+15,0,392,392,0,52,52,0,340,340,0,162,"Pattern cycling"
138,2,2.57467e+18,2.57467e+18,0,446,446,0,32,32,0,414,414,0,162,"Pattern cycling"
138,3,1.02807e+13,1.02807e+13,0,577,577,0,45,45,0,532,532,0,162,"Pattern cycling"
139,0,3.64662e+22,3.64662e+22,0,461,461,0,9,9,0,452,452,0,146,"Set pattern"
139,1,2.09788e+18,2.09788e+18,0,441,441,0,29,29,0,412,412,0,146,"Set pattern"
139,2,3.32135e+17,3.32135e+17,0,434,434,0,40,40,0,394,394,0,146,"Set pattern"
139,3,1.13586e+11,1.13586e+11,0,461,461,0,9,9,0,452,452,0,146,"Set pattern"
140,0,2.92033e+20,2.92033e+20,0,419,419,0,9,9,0,410,410,0,188,"Pattern cycling"
140,1,4.3192e+22,4.3192e+22,0,536,536,0,27,27,0,509,509,0,188,"Pattern cycling"
140,2,6.17258e+21,6.17258e+21,0,508,508,0,18,18,0,490,490,0,188,"Pattern cycling"
140,3,2.4989e+11,2.4989e+11,0,466,466,0,0,0,0,466,466,0,188,"Pattern cycling"
141,0,3.34025e+15,3.34025e+15,0,325,325,0,14,14,0,311,311,0,107,"Pattern cycling"
141,1,2.69903e+15,2.69903e+15,0,380,380,0,33,33,0,347,347,0,107,"Pattern cycling"
141,2,1.98517e+15,1.98517e+15,0,357,357,0,13,13,0,344,344,0,107,"Pattern cycling"
141,3,1.57494e+18,1.57494e+18,0,769,769,0,25,25,0,744,744,0,107,"Pattern cycling"
142,0,2.08477e+18,2.08477e+18,0,369,369,0,2,2,0,367,367,0,157,"Pattern cycling"
142,1,4.08715e+19,4.08715e+19,0,443,443,0,2,2,0,441,441,0,157,"Pattern cycling"
142,2,2.57467e+18,2.57467e+18,0,428,428,0,14,14,0,414,414,0,157,"Pattern cycling"
142,3,8.62659e+11,8.62659e+11,0,498,498,0,10,10,0,488,488,0,157,"Pattern cycling"
143,0,1.61849e+24,1.61849e+24,0,486,486,0,1,1,0,485,485,0,189,"Pattern cycling"
143,1,9.29711e+21,9.29711e+21,0,495,495,0,1,1,0,494,494,0,189,"Pattern cycling"
143,2,1.27425e+28,1.27425e+28,0,638,638,0,6,6,0,632,632,0,189,"Pattern cycling"
143,3,1.41629e+19,1.41629e+19,0,784,784,0,1,1,0,783,783,0,189,"Pattern cycling"
144,0,2.06062e+21,2.06062e+21,0,485,485,0,58,58,0,427,427,0,63,"Set pattern"
144,1,3.48178e+14,3.48178e+14,0,440,440,0,113,113,0,327,327,0,63,"Set pattern"
144,2,3.30357e+13,3.30357e+13,0,430,430,0,126,126,0,304,304,0,63,"Set pattern"
144,3,1.28782e+13,1.28782e+13,0,536,536,0,0,0,0,536,536,0,63,"Set pattern"
145,0,9.39767e+15,9.39767e+15,0,320,320,0,0,0,0,320,320,0,85,"Pattern cycling"
145,1,1.70938e+18,1.70938e+18,0,410,410,0,0,0,0,410,410,0,85,"Pattern cycling"
145,2,3.48178e+14,3.48178e+14,0,332,332,0,5,5,0,327,327,0,85,"Pattern cycling"
145,3,3.73048e+12,3.73048e+12,0,514,514,0,0,0,0,514,514,0,85,"Pattern cycling"
146,0,1.66308e+17,1.66308e+17,0,366,366,0,21,21,0,345,345,0,117,"Pattern cycling"
146,1,4.98919e+15,4.98919e+15,0,361,361,0,8,8,0,353,353,0,117,"Pattern cycling"
146,2,8.75053e+14,8.75053e+14,0,380,380,0,44,44,0,336,336,0,117,"Pattern cycling"
146,3,2466810000,2466810000,0,388,388,0,4,4,0,384,384,0,117,"Pattern cycling"
147,0,5.28983e+15,5.28983e+15,0,316,316,0,1,1,0,315,315,0,126,"Pattern cycling"
147,1,1.53888e+16,1.53888e+16,0,365,365,0,1,1,0,364,364,0,126,"Pattern cycling"
147,2,9.7462e+18,9.7462e+18,0,428,428,0,1,1,0,427,427,0,126,"Pattern cycling"
147,3,206992000,206992000,0,341,341,0,1,1,0,340,340,0,126,"Pattern cycling"
148,0,6813820000,6813820000,0,209,209,0,12,12,0,197,197,0,3,"Pattern cycling"
148,1,1604580000,1604580000,0,217,217,0,10,10,0,207,207,0,3,"Pattern cycling"
148,2,638451000,638451000,0,248,248,0,50,50,0,198,198,0,3,"Pattern cycling"
148,3,13865500,13865500,0,292,292,0,0,0,0,292,292,0,3,"Pattern cycling"
149,0,2.33869e+18,2.33869e+18,0,376,376,0,8,8,0,368,368,0,159,"Pattern cycling"
149,1,2.20512e+17,2.20512e+17,0,410,410,0,20,20,0,390,390,0,159,"Pattern cycling"
149,2,9.2722e+19,9.2722e+19,0,457,457,0,8,8,0,449,449,0,159,"Pattern cycling"
149,3,6.63689e+14,6.63689e+14,0,606,606,0,0,0,0,606,606,0,159,"Pattern cycling"
150,0,1.05015e+17,1.05015e+17,0,413,413,0,72,72,0,341,341,0,180,"Pattern cycling"
150,1,1.55548e+24,1.55548e+24,0,544,544,0,0,0,0,544,544,0,180,"Pattern cycling"
150,2,3.50992e+20,3.50992e+20,0,494,494,0,32,32,0,462,462,0,180,"Pattern cycling"
150,3,32271300,32271300,0,331,331,0,24,24,0,307,307,0,180,"Pattern cycling"
151,0,7.43879e+16,7.43879e+16,0,354,354,0,16,16,0,338,338,0,118,"Pattern cycling"
151,1,2.69903e+15,2.69903e+15,0,377,377,0,30,30,0,347,347,0,118,"Pattern cycling"
151,2,4.98919e+15,4.98919e+15,0,442,442,0,89,89,0,353,353,0,118,"Pattern cycling"
151,3,2.2764e+14,2.2764e+14,0,596,596,0,9,9,0,587,587,0,118,"Pattern cycling"
152,0,9.18127e+21,9.18127e+21,0,440,440,0,0,0,0,440,440,0,183,"Pattern cycling"
152,1,2.00121e+21,2.00121e+21,0,479,479,0,0,0,0,479,479,0,183,"Pattern cycling"
152,2,6.83813e+21,6.83813e+21,0,491,491,0,0,0,0,491,491,0,183,"Pattern cycling"
152,3,2.58095e+16,2.58095e+16,0,671,671,0,0,0,0,671,671,0,183,"Pattern cycling"
153,0,5.28983e+15,5.28983e+15,0,329,329,0,14,14,0,315,315,0,29,"Pattern cycling"
153,1,7.47448e+11,7.47448e+11,0,277,277,0,10,10,0,267,267,0,29,"Pattern cycling"
153,2,6.09032e+11,6.09032e+11,0,291,291,0,26,26,0,265,265,0,29,"Pattern cycling"
153,3,27788100000,27788100000,0,439,439,0,12,12,0,427,427,0,29,"Pattern cycling"
154,0,2.06864e+20,2.06864e+20,0,431,431,0,24,24,0,407,407,0,41,"Set pattern"
154,1,5.23019e+12,5.23019e+12,0,376,376,0,90,90,0,286,286,0,41,"Set pattern"
154,2,2.42981e+13,2.42981e+13,0,383,383,0,82,82,0,301,301,0,41,"Set pattern"
154,3,68422400000,68422400000,0,449,449,0,6,6,0,443,443,0,41,"Set pattern"
155,0,1.06658e+13,1.06658e+13,0,285,285,0,24,24,0,261,261,0,36,"Pattern cycling"
155,1,1.87851e+12,1.87851e+12,0,291,291,0,15,15,0,276,276,0,36,"Pattern cycling"
155,2,2.6918e+13,2.6918e+13,0,308,308,0,6,6,0,302,302,0,36,"Pattern cycling"
155,3,46130400000,46130400000,0,437,437,0,1,1,0,436,436,0,36,"Pattern cycling"
156,0,5.08838e+25,5.08838e+25,0,516,516,0,1,1,0,515,515,0,181,"Pattern cycling"
156,1,1.19934e+21,1.19934e+21,0,479,479,0,5,5,0,474,474,0,181,"Pattern cycling"
156,2,2.10917e+22,2.10917e+22,0,503,503,0,1,1,0,502,502,0,181,"Pattern cycling"
156,3,1.42547e+20,1.42547e+20,0,825,825,0,1,1,0,824,824,0,181,"Pattern cycling"
157,0,1.79459e+27,1.79459e+27,0,553,553,0,7,7,0,546,546,0,200,"Pattern cycling"
157,1,7.18769e+20,7.18769e+20,0,476,476,0,7,7,0,469,469,0,200,"Pattern cycling"
157,2,4.82358e+28,4.82358e+28,0,658,658,0,13,13,0,645,645,0,200,"Pattern cycling"
157,3,1.04527e+33,1.04527e+33,0,1368,1368,0,18,18,0,1350,1350,0,200,"Pattern cycling"
158,0,7.46773e+15,7.46773e+15,0,349,349,0,31,31,0,318,318,0,111,"Pattern cycling"
158,1,1.62189e+17,1.62189e+17,0,400,400,0,13,13,0,387,387,0,111,"Pattern cycling"
158,2,3.31245e+15,3.31245e+15,0,416,416,0,67,67,0,349,349,0,111,"Pattern cycling"
158,3,2.24718e+12,2.24718e+12,0,572,572,0,67,67,0,505,505,0,111,"Pattern cycling"
159,0,4.25274e+12,4.25274e+12,0,253,253,0,0,0,0,253,253,0,24,"Pattern cycling"
159,1,4.49153e+13,4.49153e+13,0,326,326,0,19,19,0,307,307,0,24,"Pattern cycling"
159,2,3.29472e+11,3.29472e+11,0,259,259,0,0,0,0,259,259,0,24,"Pattern cycling"
159,3,2760920000,2760920000,0,386,386,0,0,0,0,386,386,0,24,"Pattern cycling"
160,0,1.85121e+19,1.85121e+19,0,426,426,0,40,40,0,386,386,0,123,"Pattern cycling"
160,1,8.32495e+15,8.32495e+15,0,412,412,0,54,54,0,358,358,0,123,"Pattern cycling"
160,2,3.86756e+16,3.86756e+16,0,516,516,0,143,143,0,373,373,0,123,"Pattern cycling"
160,3,3.77901e+14,3.77901e+14,0,618,618,0,22,22,0,596,596,0,123,"Pattern cycling"
161,0,2.5532e+25,2.5532e+25,0,604,604,0,95,95,0,509,509,0,196,"Pattern cycling"
161,1,1.63939e+25,1.63939e+25,0,677,677,0,110,110,0,567,567,0,196,"Pattern cycling"
161,2,8.00554e+24,8.00554e+24,0,664,664,0,104,104,0,560,560,0,196,"Pattern cycling"
161,3,2.73549e+25,2.73549e+25,0,1142,1142,0,102,102,0,1040,1040,0,196,"Pattern cycling"
162,0,9.54476e+11,9.54476e+11,0,248,248,0,8,8,0,240,240,0,33,"Pattern cycling"
162,1,1.25054e+14,1.25054e+14,0,325,325,0,8,8,0,317,317,0,33,"Pattern cycling"
162,2,8.72708e+12,8.72708e+12,0,303,303,0,12,12,0,291,291,0,33,"Pattern cycling"
162,3,8.15419e+11,8.15419e+11,0,491,491,0,4,4,0,487,487,0,33,"Pattern cycling"
163,0,1.19186e+14,1.19186e+14,0,378,378,0,96,96,0,282,282,0,94,"Pattern cycling"
163,1,2.31785e+16,2.31785e+16,0,415,415,0,47,47,0,368,368,0,94,"Pattern cycling"
163,2,7.89885e+14,7.89885e+14,0,399,399,0,64,64,0,335,335,0,94,"Pattern cycling"
163,3,1.44136e+13,1.44136e+13,0,624,624,0,86,86,0,538,538,0,94,"Pattern cycling"
164,0,9.28884e+18,9.28884e+18,0,420,420,0,40,40,0,380,380,0,163,"Pattern cycling"
164,1,5.55688e+19,5.55688e+19,0,567,567,0,123,123,0,444,444,0,163,"Pattern cycling"
164,2,2.57467e+18,2.57467e+18,0,561,561,0,147,147,0,414,414,0,163,"Pattern cycling"
164,3,4664.48,4664.48,0,510,510,0,360,360,0,150,150,0,163,"Pattern cycling"
165,0,5.91114e+16,5.91114e+16,0,367,367,0,31,31,0,336,336,0,139,"Pattern cycling"
165,1,1.32509e+19,1.32509e+19,0,512,512,0,82,82,0,430,430,0,139,"Pattern cycling"
165,2,1.07681e+17,1.07681e+17,0,420,420,0,37,37,0,383,383,0,139,"Pattern cycling"
165,3,2.54781e+14,2.54781e+14,0,594,594,0,5,5,0,589,589,0,139,"Pattern cycling"
166,0,4.1872e+16,4.1872e+16,0,355,355,0,22,22,0,333,333,0,97,"Pattern cycling"
166,1,4.98919e+15,4.98919e+15,0,362,362,0,9,9,0,353,353,0,97,"Pattern cycling"
166,2,1.07393e+15,1.07393e+15,0,400,400,0,62,62,0,338,338,0,97,"Pattern cycling"
166,3,5.9299e+14,5.9299e+14,0,699,699,0,95,95,0,604,604,0,97,"Pattern cycling"
167,0,3.35324e+14,3.35324e+14,0,311,311,0,20,20,0,291,291,0,26,"Pattern cycling"
167,1,9.17321e+11,9.17321e+11,0,284,284,0,15,15,0,269,269,0,26,"Pattern cycling"
167,2,4.04351e+11,4.04351e+11,0,278,278,0,17,17,0,261,261,0,26,"Pattern cycling"
167,3,10083300000,10083300000,0,424,424,0,15,15,0,409,409,0,26,"Pattern cycling"
168,0,9.32498e+17,9.32498e+17,0,428,428,0,68,68,0,360,360,0,57,"Set pattern"
168,1,1.78715e+13,1.78715e+13,0,403,403,0,105,105,0,298,298,0,57,"Set pattern"
168,2,1.97985e+13,1.97985e+13,0,402,402,0,103,103,0,299,299,0,57,"Set pattern"
168,3,1.35366e+12,1.35366e+12,0,496,496,0,0,0,0,496,496,0,57,"Set pattern"
169,0,1.03396e+21,1.03396e+21,0,457,457,0,36,36,0,421,421,0,42,"Set pattern"
169,1,5.79412e+12,5.79412e+12,0,400,400,0,113,113,0,287,287,0,42,"Set pattern"
169,2,2.6918e+13,2.6918e+13,0,406,406,0,104,104,0,302,302,0,42,"Set pattern"
169,3,6.50947e+11,6.50947e+11,0,488,488,0,5,5,0,483,483,0,42,"Set pattern"
170,0,4.26929e+11,4.26929e+11,0,247,247,0,14,14,0,233,233,0,16,"Pattern cycling"
170,1,8.7037e+10,8.7037e+10,0,249,249,0,3,3,0,246,246,0,16,"Pattern cycling"
170,2,96421500000,96421500000,0,264,264,0,17,17,0,247,247,0,16,"Pattern cycling"
170,3,14955900000,14955900000,0,416,416,0,0,0,0,416,416,0,16,"Pattern cycling"
171,0,3.34025e+15,3.34025e+15,0,345,345,0,34,34,0,311,311,0,112,"Pattern cycling"
171,1,9.72008e+16,9.72008e+16,0,393,393,0,11,11,0,382,382,0,112,"Pattern cycling"
171,2,7.5147e+15,7.5147e+15,0,372,372,0,15,15,0,357,357,0,112,"Pattern cycling"
171,3,1230870,1230870,0,321,321,0,72,72,0,249,249,0,112,"Pattern cycling"
172,0,2.29373e+23,2.29373e+23,0,509,509,0,41,41,0,468,468,0,58,"Set pattern"
172,1,7.11096e+12,7.11096e+12,0,446,446,0,157,157,0,289,289,0,58,"Set pattern"
172,2,2.6918e+13,2.6918e+13,0,439,439,0,137,137,0,302,302,0,58,"Set pattern"
172,3,1.70667e+13,1.70667e+13,0,544,544,0,3,3,0,541,541,0,58,"Set pattern"
173,0,1.30624e+20,1.30624e+20,0,431,431,0,28,28,0,403,403,0,141,"Pattern cycling"
173,1,4.74654e+16,4.74654e+16,0,416,416,0,41,41,0,375,375,0,141,"Pattern cycling"
173,2,9.72008e+16,9.72008e+16,0,414,414,0,32,32,0,382,382,0,141,"Pattern cycling"
173,3,1.93499e+15,1.93499e+15,0,626,626,0,1,1,0,625,625,0,141,"Pattern cycling"
174,0,67874100000,67874100000,0,217,217,0,0,0,0,217,217,0,19,"Pattern cycling"
174,1,1.18335e+11,1.18335e+11,0,254,254,0,5,5,0,249,249,0,19,"Pattern cycling"
174,2,2.68459e+11,2.68459e+11,0,261,261,0,4,4,0,257,257,0,19,"Pattern cycling"
174,3,206992000,206992000,0,340,340,0,0,0,0,340,340,0,19,"Pattern cycling"
175,0,1.34223e+13,1.34223e+13,0,295,295,0,32,32,0,263,263,0,60,"Pattern cycling"
175,1,1.07681e+17,1.07681e+17,0,456,456,0,73,73,0,383,383,0,60,"Pattern cycling"
175,2,2.42981e+13,2.42981e+13,0,406,406,0,105,105,0,301,301,0,60,"Pattern cycling"
175,3,1.68476e+11,1.68476e+11,0,477,477,0,18,18,0,459,459,0,60,"Pattern cycling"
176,0,7.23934e+23,7.23934e+23,0,628,628,0,150,150,0,478,478,0,192,"Pattern cycling"
176,1,1.635e+23,1.635e+23,0,744,744,0,222,222,0,522,522,0,192,"Pattern cycling"
176,2,1.33222e+23,1.33222e+23,0,658,658,0,138,138,0,520,520,0,192,"Pattern cycling"
176,3,9.84408e+14,9.84408e+14,0,805,805,0,192,192,0,613,613,0,192,"Pattern cycling"
177,0,1.66955e+16,1.66955e+16,0,325,325,0,0,0,0,325,325,0,83,"Pattern cycling"
177,1,3.1429e+14,3.1429e+14,0,365,365,0,39,39,0,326,326,0,83,"Pattern cycling"
177,2,7.89885e+14,7.89885e+14,0,350,350,0,15,15,0,335,335,0,83,"Pattern cycling"
177,3,4583330000,4583330000,0,395,395,0,0,0,0,395,395,0,83,"Pattern cycling"
178,0,4.20349e+15,4.20349e+15,0,348,348,0,35,35,0,313,313,0,119,"Pattern cycling"
178,1,1.318e+15,1.318e+15,0,366,366,0,26,26,0,340,340,0,119,"Pattern cycling"
178,2,9.24735e+17,9.24735e+17,0,448,448,0,44,44,0,404,404,0,119,"Pattern cycling"
178,3,5.04054e+15,5.04054e+15,0,676,676,0,34,34,0,642,642,0,119,"Pattern cycling"
179,0,2.09288e+17,2.09288e+17,0,381,381,0,34,34,0,347,347,0,154,"Pattern cycling"
179,1,6.80153e+17,6.80153e+17,0,426,426,0,25,25,0,401,401,0,154,"Pattern cycling"
179,2,8.79762e+18,8.79762e+18,0,462,462,0,36,36,0,426,426,0,154,"Pattern cycling"
179,3,3.61852e+16,3.61852e+16,0,677,677,0,0,0,0,677,677,0,154,"Pattern cycling"
180,0,2.92033e+20,2.92033e+20,0,448,448,0,38,38,0,410,410,0,175,"Pattern cycling"
180,1,6.8198e+19,6.8198e+19,0,509,509,0,63,63,0,446,446,0,175,"Pattern cycling"
180,2,1.71398e+20,1.71398e+20,0,549,549,0,94,94,0,455,455,0,175,"Pattern cycling"
180,3,61.0217,61.0217,0,73,73,0,0,0,0,73,73,0,175,"Pattern cycling"
181,0,2.88651e+23,2.88651e+23,0,480,480,0,10,10,0,470,470,0,193,"Pattern cycling"
181,1,5.58678e+23,5.58678e+23,0,539,539,0,5,5,0,534,534,0,193,"Pattern cycling"
181,2,6.18916e+23,6.18916e+23,0,565,565,0,30,30,0,535,535,0,193,"Pattern cycling"
181,3,11710100,11710100,0,289,289,0,0,0,0,289,289,0,193,"Pattern cycling"
182,0,1.06245e+14,1.06245e+14,0,285,285,0,4,4,0,281,281,0,35,"Reactive meandering"
182,1,1.38167e+12,1.38167e+12,0,277,277,0,4,4,0,273,273,0,35,"Reactive meandering"
182,2,1.24719e+12,1.24719e+12,0,276,276,0,4,4,0,272,272,0,35,"Reactive meandering"
182,3,406872000,406872000,0,356,356,0,4,4,0,352,352,0,35,"Reactive meandering"
183,0,1.20582e+11,1.20582e+11,0,234,234,0,12,12,0,222,222,0,64,"Pattern cycling"
183,1,8.30265e+13,8.30265e+13,0,335,335,0,22,22,0,313,313,0,64,"Pattern cycling"
183,2,4.27309e+14,4.27309e+14,0,343,343,0,14,14,0,329,329,0,64,"Pattern cycling"
183,3,2760920000,2760920000,0,400,400,0,14,14,0,386,386,0,64,"Pattern cycling"
184,0,1.8729e+16,1.8729e+16,0,387,387,0,61,61,0,326,326,0,49,"Pattern cycling"
184,1,1.12883e+14,1.12883e+14,0,325,325,0,9,9,0,316,316,0,49,"Pattern cycling"
184,2,1.18653e+13,1.18653e+13,0,354,354,0,60,60,0,294,294,0,49,"Pattern cycling"
184,3,81016700000,81016700000,0,455,455,0,9,9,0,446,446,0,49,"Pattern cycling"
185,0,1.18724e+15,1.18724e+15,0,345,345,0,43,43,0,302,302,0,95,"Pattern cycling"
185,1,5.24424e+14,5.24424e+14,0,349,349,0,18,18,0,331,331,0,95,"Pattern cycling"
185,2,5.25833e+16,5.25833e+16,0,410,410,0,34,34,0,376,376,0,95,"Pattern cycling"
185,3,7.42817e+14,7.42817e+14,0,621,621,0,13,13,0,608,608,0,95,"Pattern cycling"
186,0,1.1554e+22,1.1554e+22,0,493,493,0,51,51,0,442,442,0,75,"Set pattern"
186,1,6.4534e+16,6.4534e+16,0,470,470,0,92,92,0,378,378,0,75,"Set pattern"
186,2,1.53475e+14,1.53475e+14,0,434,434,0,115,115,0,319,319,0,75,"Set pattern"
186,3,1.61321e+13,1.61321e+13,0,540,540,0,0,0,0,540,540,0,75,"Set pattern"
187,0,6.02702e+11,6.02702e+11,0,248,248,0,12,12,0,236,236,0,20,"Pattern cycling"
187,1,1.18335e+11,1.18335e+11,0,262,262,0,13,13,0,249,249,0,20,"Pattern cycling"
187,2,5.51233e+13,5.51233e+13,0,319,319,0,10,10,0,309,309,0,20,"Pattern cycling"
187,3,570440000,570440000,0,359,359,0,1,1,0,358,358,0,20,"Pattern cycling"
188,0,1.01803e+25,1.01803e+25,0,506,506,0,5,5,0,501,501,0,149,"Pattern cycling"
188,1,7.53489e+17,7.53489e+17,0,419,419,0,17,17,0,402,402,0,149,"Pattern cycling"
188,2,4.98919e+15,4.98919e+15,0,373,373,0,20,20,0,353,353,0,149,"Pattern cycling"
188,3,3.97219e+13,3.97219e+13,0,560,560,0,4,4,0,556,556,0,149,"Pattern cycling"
189,0,5.88823e+17,5.88823e+17,0,368,368,0,12,12,0,356,356,0,132,"Reactive meandering"
189,1,3.15135e+16,3.15135e+16,0,381,381,0,10,10,0,371,371,0,132,"Reactive meandering"
189,2,1.2539e+16,1.2539e+16,0,389,389,0,27,27,0,362,362,0,132,"Reactive meandering"
189,3,1.13586e+11,1.13586e+11,0,461,461,0,9,9,0,452,452,0,132,"Reactive meandering"
190,0,1.20582e+11,1.20582e+11,0,240,240,0,18,18,0,222,222,0,21,"Pattern cycling"
190,1,1.60889e+11,1.60889e+11,0,265,265,0,13,13,0,252,252,0,21,"Pattern cycling"
190,2,47084900000,47084900000,0,265,265,0,25,25,0,240,240,0,21,"Pattern cycling"
190,3,1969250000,1969250000,0,384,384,0,4,4,0,380,380,0,21,"Pattern cycling"
191,0,4.21985e+14,4.21985e+14,0,313,313,0,20,20,0,293,293,0,171,"Pattern cycling"
191,1,1.62625e+19,1.62625e+19,0,444,444,0,12,12,0,432,432,0,171,"Pattern cycling"
191,2,7.55513e+19,7.55513e+19,0,507,507,0,60,60,0,447,447,0,171,"Pattern cycling"
191,3,4.91193e+11,4.91193e+11,0,502,502,0,24,24,0,478,478,0,171,"Pattern cycling"
192,0,6.55433e+19,6.55433e+19,0,410,410,0,13,13,0,397,397,0,89,"Pattern cycling"
192,1,4.06527e+15,4.06527e+15,0,355,355,0,4,4,0,351,351,0,89,"Pattern cycling"
192,2,5.80969e+14,5.80969e+14,0,350,350,0,18,18,0,332,332,0,89,"Pattern cycling"
192,3,3.77901e+14,3.77901e+14,0,597,597,0,1,1,0,596,596,0,89,"Pattern cycling"
193,0,1.7089e+10,1.7089e+10,0,209,209,0,4,4,0,205,205,0,11,"Pattern cycling"
193,1,1.78236e+11,1.78236e+11,0,261,261,0,8,8,0,253,253,0,11,"Pattern cycling"
193,2,3.47245e+12,3.47245e+12,0,288,288,0,6,6,0,282,282,0,11,"Pattern cycling"
193,3,50639200,50639200,0,324,324,0,9,9,0,315,315,0,11,"Pattern cycling"
194,0,9.11025e+23,9.11025e+23,0,551,551,0,71,71,0,480,480,0,99,"Set pattern"
194,1,1.18972e+15,1.18972e+15,0,498,498,0,159,159,0,339,339,0,99,"Set pattern"
194,2,1.98517e+15,1.98517e+15,0,492,492,0,148,148,0,344,344,0,99,"Set pattern"
194,3,8.79545e+14,8.79545e+14,0,613,613,0,2,2,0,611,611,0,99,"Set pattern"
195,0,1.50571e+13,1.50571e+13,0,352,352,0,88,88,0,264,264,0,71,"Pattern cycling"
195,1,6.76512e+13,6.76512e+13,0,345,345,0,34,34,0,311,311,0,71,"Pattern cycling"
195,2,4.98919e+15,4.98919e+15,0,408,408,0,55,55,0,353,353,0,71,"Pattern cycling"
195,3,7.8079e+13,7.8079e+13,0,600,600,0,32,32,0,568,568,0,71,"Pattern cycling"
196,0,3.21304e+25,3.21304e+25,0,552,552,0,41,41,0,511,511,0,195,"Pattern cycling"
196,1,7.22637e+24,7.22637e+24,0,660,660,0,101,101,0,559,559,0,195,"Pattern cycling"
196,2,2.24693e+31,2.24693e+31,0,811,811,0,106,106,0,705,705,0,195,"Pattern cycling"
196,3,4.74252e+23,4.74252e+23,0,988,988,0,20,20,0,968,968,0,195,"Pattern cycling"
197,0,12105100000,12105100000,0,206,206,0,4,4,0,202,202,0,6,"Pattern cycling"
197,1,18734800000,18734800000,0,247,247,0,16,16,0,231,231,0,6,"Pattern cycling"
197,2,25471800000,25471800000,0,244,244,0,10,10,0,234,234,0,6,"Pattern cycling"
197,3,446639,446639,0,247,247,0,16,16,0,231,231,0,6,"Pattern cycling"
198,0,7.55523e+12,7.55523e+12,0,290,290,0,32,32,0,258,258,0,39,"Reactive meandering"
198,1,5.79412e+12,5.79412e+12,0,329,329,0,42,42,0,287,287,0,39,"Reactive meandering"
198,2,3.47245e+12,3.47245e+12,0,334,334,0,52,52,0,282,282,0,39,"Reactive meandering"
198,3,1351.18,1351.18,0,130,130,0,2,2,0,128,128,0,39,"Reactive meandering"
199,0,3.36629e+13,3.36629e+13,0,280,280,0,9,9,0,271,271,0,43,"Pattern cycling"
199,1,6.41886e+12,6.41886e+12,0,301,301,0,13,13,0,288,288,0,43,"Pattern cycling"
199,2,6.747e+11,6.747e+11,0,279,279,0,13,13,0,266,266,0,43,"Pattern cycling"
199,3,356551,356551,0,227,227,0,0,0,0,227,227,0,43,"Pattern cycling"
200,0,9.43423e+14,9.43423e+14,0,380,380,0,80,80,0,300,300,0,73,"Pattern cycling"
200,1,1.01896e+14,1.01896e+14,0,417,417,0,102,102,0,315,315,0,73,"Pattern cycling"
200,2,2.98204e+13,2.98204e+13,0,424,424,0,121,121,0,303,303,0,73,"Pattern cycling"
200,3,1.80555e+13,1.80555e+13,0,557,557,0,15,15,0,542,542,0,73,"Pattern cycling"
