"seed","map_idx","merit_mean","merit_median","merit_sd","nutrients_consumed_mean","nutrients_consumed_median","nutrients_consumed_sd","moves_off_path_mean","moves_off_path_median","moves_off_path_sd","base_score_mean","base_score_median","base_score_sd","seed_order"
1,0,4.21985e+14,4.21985e+14,NA,356,356,NA,63,63,NA,293,293,NA,21
1,1,3.29472e+11,3.29472e+11,NA,341,341,NA,82,82,NA,259,259,NA,21
1,2,1.60889e+11,1.60889e+11,NA,337,337,NA,85,85,NA,252,252,NA,21
1,3,16739100000,16739100000,NA,418,418,NA,0,0,NA,418,418,NA,21
2,0,2.3206e+20,2.3206e+20,NA,487,487,NA,79,79,NA,408,408,NA,148
2,1,1.02444e+18,1.02444e+18,NA,483,483,NA,78,78,NA,405,405,NA,148
2,2,9.69404e+14,9.69404e+14,NA,466,466,NA,129,129,NA,337,337,NA,148
2,3,1.03473e+14,1.03473e+14,NA,573,573,NA,0,0,NA,573,573,NA,148
3,0,3.31441e+17,3.31441e+17,NA,427,427,NA,76,76,NA,351,351,NA,120
3,1,1.98517e+15,1.98517e+15,NA,414,414,NA,70,70,NA,344,344,NA,120
3,2,2.31785e+16,2.31785e+16,NA,462,462,NA,94,94,NA,368,368,NA,120
3,3,8.68251e+12,8.68251e+12,NA,529,529,NA,0,0,NA,529,529,NA,120
4,0,2.60325e+20,2.60325e+20,NA,451,451,NA,42,42,NA,409,409,NA,175
4,1,3.1683e+20,3.1683e+20,NA,500,500,NA,39,39,NA,461,461,NA,175
4,2,5.27246e+18,5.27246e+18,NA,462,462,NA,41,41,NA,421,421,NA,175
4,3,5.7786e+10,5.7786e+10,NA,479,479,NA,39,39,NA,440,440,NA,175
5,0,1.19649e+13,1.19649e+13,NA,265,265,NA,3,3,NA,262,262,NA,10
5,1,16911300000,16911300000,NA,243,243,NA,13,13,NA,230,230,NA,10
5,2,47084900000,47084900000,NA,262,262,NA,22,22,NA,240,240,NA,10
5,3,32271300,32271300,NA,316,316,NA,9,9,NA,307,307,NA,10
6,0,2.69583e+11,2.69583e+11,NA,235,235,NA,6,6,NA,229,229,NA,19
6,1,2.18744e+11,2.18744e+11,NA,258,258,NA,3,3,NA,255,255,NA,19
6,2,64016600000,64016600000,NA,246,246,NA,3,3,NA,243,243,NA,19
6,3,79461400,79461400,NA,334,334,NA,11,11,NA,323,323,NA,19
7,0,1.05015e+17,1.05015e+17,NA,370,370,NA,29,29,NA,341,341,NA,132
7,1,1.88862e+16,1.88862e+16,NA,393,393,NA,27,27,NA,366,366,NA,132
7,2,1.70938e+18,1.70938e+18,NA,437,437,NA,27,27,NA,410,410,NA,132
7,3,1.71773e+14,1.71773e+14,NA,602,602,NA,20,20,NA,582,582,NA,132
8,0,5.37263e+11,5.37263e+11,NA,240,240,NA,5,5,NA,235,235,NA,12
8,1,8.7037e+10,8.7037e+10,NA,252,252,NA,6,6,NA,246,246,NA,12
8,2,78565800000,78565800000,NA,265,265,NA,20,20,NA,245,245,NA,12
8,3,1541870,1541870,NA,258,258,NA,5,5,NA,253,253,NA,12
9,0,3.66081e+21,3.66081e+21,NA,520,520,NA,88,88,NA,432,432,NA,99
9,1,1.18972e+15,1.18972e+15,NA,496,496,NA,157,157,NA,339,339,NA,99
9,2,2.19921e+15,2.19921e+15,NA,487,487,NA,142,142,NA,345,345,NA,99
9,3,4.47459e+14,4.47459e+14,NA,599,599,NA,0,0,NA,599,599,NA,99
10,0,1.70228e+11,1.70228e+11,NA,249,249,NA,24,24,NA,225,225,NA,5
10,1,1307430000,1307430000,NA,211,211,NA,6,6,NA,205,205,NA,5
10,2,12438500000,12438500000,NA,280,280,NA,53,53,NA,227,227,NA,5
10,3,124688000,124688000,NA,336,336,NA,5,5,NA,331,331,NA,5
11,0,5.84268e+19,5.84268e+19,NA,399,399,NA,3,3,NA,396,396,NA,167
11,1,8.79762e+18,8.79762e+18,NA,429,429,NA,3,3,NA,426,426,NA,167
11,2,1.54716e+20,1.54716e+20,NA,457,457,NA,3,3,NA,454,454,NA,167
11,3,6.63689e+14,6.63689e+14,NA,609,609,NA,3,3,NA,606,606,NA,167
12,0,1.86564e+17,1.86564e+17,NA,370,370,NA,24,24,NA,346,346,NA,97
12,1,7.89885e+14,7.89885e+14,NA,431,431,NA,96,96,NA,335,335,NA,97
12,2,2.43634e+15,2.43634e+15,NA,484,484,NA,138,138,NA,346,346,NA,97
12,3,9.71769e+12,9.71769e+12,NA,557,557,NA,26,26,NA,531,531,NA,97
13,0,5.75264e+23,5.75264e+23,NA,535,535,NA,59,59,NA,476,476,NA,129
13,1,3.15135e+16,3.15135e+16,NA,510,510,NA,139,139,NA,371,371,NA,129
13,2,2.84463e+16,2.84463e+16,NA,483,483,NA,113,113,NA,370,370,NA,129
13,3,8.79545e+14,8.79545e+14,NA,611,611,NA,0,0,NA,611,611,NA,129
14,0,5.33107e+13,5.33107e+13,NA,291,291,NA,16,16,NA,275,275,NA,26
14,1,1.18335e+11,1.18335e+11,NA,275,275,NA,26,26,NA,249,249,NA,26
14,2,6.747e+11,6.747e+11,NA,282,282,NA,16,16,NA,266,266,NA,26
14,3,94087500,94087500,NA,330,330,NA,4,4,NA,326,326,NA,26
15,0,8.37731e+15,8.37731e+15,NA,331,331,NA,12,12,NA,319,319,NA,114
15,1,1.2539e+16,1.2539e+16,NA,381,381,NA,19,19,NA,362,362,NA,114
15,2,2.19921e+15,2.19921e+15,NA,374,374,NA,29,29,NA,345,345,NA,114
15,3,3.5262e+12,3.5262e+12,NA,533,533,NA,20,20,NA,513,513,NA,114
16,0,5.16802e+21,5.16802e+21,NA,471,471,NA,36,36,NA,435,435,NA,185
16,1,1.47191e+21,1.47191e+21,NA,502,502,NA,26,26,NA,476,476,NA,185
16,2,9.29711e+21,9.29711e+21,NA,542,542,NA,48,48,NA,494,494,NA,185
16,3,2.36639e+20,2.36639e+20,NA,907,907,NA,74,74,NA,833,833,NA,185
17,0,1.69568e+12,1.69568e+12,NA,256,256,NA,11,11,NA,245,245,NA,20
17,1,1.06818e+11,1.06818e+11,NA,250,250,NA,2,2,NA,248,248,NA,20
17,2,64016600000,64016600000,NA,260,260,NA,17,17,NA,243,243,NA,20
17,3,1.99486e+11,1.99486e+11,NA,464,464,NA,2,2,NA,462,462,NA,20
18,0,9.43423e+14,9.43423e+14,NA,341,341,NA,41,41,NA,300,300,NA,90
18,1,1.318e+15,1.318e+15,NA,351,351,NA,11,11,NA,340,340,NA,90
18,2,5.80969e+14,5.80969e+14,NA,366,366,NA,34,34,NA,332,332,NA,90
18,3,6667660,6667660,NA,280,280,NA,1,1,NA,279,279,NA,90
19,0,1.48827e+16,1.48827e+16,NA,332,332,NA,8,8,NA,324,324,NA,81
19,1,5.80969e+14,5.80969e+14,NA,340,340,NA,8,8,NA,332,332,NA,81
19,2,1.70023e+14,1.70023e+14,NA,328,328,NA,8,8,NA,320,320,NA,81
19,3,206992000,206992000,NA,346,346,NA,6,6,NA,340,340,NA,81
20,0,1.6311e+22,1.6311e+22,NA,521,521,NA,76,76,NA,445,445,NA,117
20,1,1.3891e+16,1.3891e+16,NA,493,493,NA,130,130,NA,363,363,NA,117
20,2,3.65977e+13,3.65977e+13,NA,465,465,NA,160,160,NA,305,305,NA,117
20,3,2.03391e+14,2.03391e+14,NA,585,585,NA,0,0,NA,585,585,NA,117
21,0,5.9804e+13,5.9804e+13,NA,284,284,NA,8,8,NA,276,276,NA,44
21,1,1.61321e+13,1.61321e+13,NA,304,304,NA,7,7,NA,297,297,NA,44
21,2,6.41886e+12,6.41886e+12,NA,304,304,NA,16,16,NA,288,288,NA,44
21,3,5031300,5031300,NA,274,274,NA,0,0,NA,274,274,NA,44
22,0,2.33869e+18,2.33869e+18,NA,386,386,NA,18,18,NA,368,368,NA,156
22,1,9.24735e+17,9.24735e+17,NA,416,416,NA,12,12,NA,404,404,NA,156
22,2,1.13795e+20,1.13795e+20,NA,485,485,NA,34,34,NA,451,451,NA,156
22,3,1.3981e+17,1.3981e+17,NA,713,713,NA,12,12,NA,701,701,NA,156
23,0,8.31251e+17,8.31251e+17,NA,470,470,NA,111,111,NA,359,359,NA,80
23,1,1.97985e+13,1.97985e+13,NA,449,449,NA,150,150,NA,299,299,NA,80
23,2,7.13007e+14,7.13007e+14,NA,457,457,NA,123,123,NA,334,334,NA,80
23,3,2.39278e+13,2.39278e+13,NA,560,560,NA,13,13,NA,547,547,NA,80
24,0,5.93414e+15,5.93414e+15,NA,336,336,NA,20,20,NA,316,316,NA,133
24,1,4.5157e+17,4.5157e+17,NA,409,409,NA,12,12,NA,397,397,NA,133
24,2,1.19292e+17,1.19292e+17,NA,410,410,NA,26,26,NA,384,384,NA,133
24,3,4.73383e+14,4.73383e+14,NA,615,615,NA,15,15,NA,600,600,NA,133
25,0,4.67901e+17,4.67901e+17,NA,411,411,NA,57,57,NA,354,354,NA,142
25,1,2.20512e+17,2.20512e+17,NA,404,404,NA,14,14,NA,390,390,NA,142
25,2,7.55513e+19,7.55513e+19,NA,479,479,NA,32,32,NA,447,447,NA,142
25,3,3.03633e+15,3.03633e+15,NA,647,647,NA,14,14,NA,633,633,NA,142
26,0,3.01247e+12,3.01247e+12,NA,265,265,NA,15,15,NA,250,250,NA,11
26,1,34631400000,34631400000,NA,251,251,NA,14,14,NA,237,237,NA,11
26,2,5.7786e+10,5.7786e+10,NA,258,258,NA,16,16,NA,242,242,NA,11
26,3,5031300,5031300,NA,292,292,NA,18,18,NA,274,274,NA,11
27,0,1.47104e+19,1.47104e+19,NA,426,426,NA,42,42,NA,384,384,NA,43
27,1,2.82941e+12,2.82941e+12,NA,378,378,NA,98,98,NA,280,280,NA,43
27,2,1.4562e+13,1.4562e+13,NA,390,390,NA,94,94,NA,296,296,NA,43
27,3,1.99486e+11,1.99486e+11,NA,465,465,NA,3,3,NA,462,462,NA,43
28,0,1.48827e+16,1.48827e+16,NA,350,350,NA,26,26,NA,324,324,NA,47
28,1,1.07105e+13,1.07105e+13,NA,335,335,NA,42,42,NA,293,293,NA,47
28,2,1.4562e+13,1.4562e+13,NA,336,336,NA,40,40,NA,296,296,NA,47
28,3,84064900,84064900,NA,350,350,NA,26,26,NA,324,324,NA,47
29,0,1.85121e+19,1.85121e+19,NA,387,387,NA,1,1,NA,386,386,NA,159
29,1,1.25727e+18,1.25727e+18,NA,410,410,NA,3,3,NA,407,407,NA,159
29,2,3.87795e+18,3.87795e+18,NA,420,420,NA,2,2,NA,418,418,NA,159
29,3,1.45071e+14,1.45071e+14,NA,585,585,NA,6,6,NA,579,579,NA,159
30,0,5.33107e+13,5.33107e+13,NA,284,284,NA,9,9,NA,275,275,NA,38
30,1,1.07105e+13,1.07105e+13,NA,293,293,NA,0,0,NA,293,293,NA,38
30,2,70919100000,70919100000,NA,270,270,NA,26,26,NA,244,244,NA,38
30,3,14668800,14668800,NA,293,293,NA,0,0,NA,293,293,NA,38
31,0,1.89484e+13,1.89484e+13,NA,289,289,NA,23,23,NA,266,266,NA,50
31,1,1.38538e+14,1.38538e+14,NA,337,337,NA,19,19,NA,318,318,NA,50
31,2,1.4562e+13,1.4562e+13,NA,329,329,NA,33,33,NA,296,296,NA,50
31,3,4.67304e+12,4.67304e+12,NA,576,576,NA,58,58,NA,518,518,NA,50
32,0,8.4099e+14,8.4099e+14,NA,347,347,NA,48,48,NA,299,299,NA,58
32,1,1.78715e+13,1.78715e+13,NA,318,318,NA,20,20,NA,298,298,NA,58
32,2,3.30357e+13,3.30357e+13,NA,379,379,NA,75,75,NA,304,304,NA,58
32,3,1.69568e+12,1.69568e+12,NA,500,500,NA,0,0,NA,500,500,NA,58
33,0,9.32498e+17,9.32498e+17,NA,382,382,NA,22,22,NA,360,360,NA,92
33,1,7.13007e+14,7.13007e+14,NA,421,421,NA,87,87,NA,334,334,NA,92
33,2,1.46011e+15,1.46011e+15,NA,378,378,NA,37,37,NA,341,341,NA,92
33,3,259292000,259292000,NA,344,344,NA,0,0,NA,344,344,NA,92
34,0,4.75224e+13,4.75224e+13,NA,336,336,NA,62,62,NA,274,274,NA,9
34,1,38365500000,38365500000,NA,284,284,NA,46,46,NA,238,238,NA,9
34,2,9148630000,9148630000,NA,317,317,NA,93,93,NA,224,224,NA,9
34,3,5129780000,5129780000,NA,397,397,NA,0,0,NA,397,397,NA,9
35,0,3.31441e+17,3.31441e+17,NA,359,359,NA,8,8,NA,351,351,NA,17
35,1,1.97454e+11,1.97454e+11,NA,335,335,NA,81,81,NA,254,254,NA,17
35,2,18734800000,18734800000,NA,299,299,NA,68,68,NA,231,231,NA,17
35,3,946974000,946974000,NA,367,367,NA,0,0,NA,367,367,NA,17
36,0,1.47104e+19,1.47104e+19,NA,427,427,NA,43,43,NA,384,384,NA,140
36,1,6.13954e+17,6.13954e+17,NA,466,466,NA,66,66,NA,400,400,NA,140
36,2,3.15135e+16,3.15135e+16,NA,431,431,NA,60,60,NA,371,371,NA,140
36,3,1.27953e+12,1.27953e+12,NA,526,526,NA,31,31,NA,495,495,NA,140
37,0,9.36125e+16,9.36125e+16,NA,389,389,NA,49,49,NA,340,340,NA,24
37,1,6.747e+11,6.747e+11,NA,362,362,NA,96,96,NA,266,266,NA,24
37,2,5.7786e+10,5.7786e+10,NA,346,346,NA,104,104,NA,242,242,NA,24
37,3,2.9398e+10,2.9398e+10,NA,428,428,NA,0,0,NA,428,428,NA,24
38,0,8.37731e+15,8.37731e+15,NA,369,369,NA,50,50,NA,319,319,NA,18
38,1,2677390000,2677390000,NA,318,318,NA,106,106,NA,212,212,NA,18
38,2,2.4233e+11,2.4233e+11,NA,340,340,NA,84,84,NA,256,256,NA,18
38,3,1759480000,1759480000,NA,398,398,NA,20,20,NA,378,378,NA,18
39,0,1.66955e+16,1.66955e+16,NA,444,444,NA,119,119,NA,325,325,NA,69
39,1,4.97582e+13,4.97582e+13,NA,438,438,NA,130,130,NA,308,308,NA,69
39,2,1.53475e+14,1.53475e+14,NA,441,441,NA,122,122,NA,319,319,NA,69
39,3,1.28782e+13,1.28782e+13,NA,548,548,NA,12,12,NA,536,536,NA,69
40,0,5.24891e+17,5.24891e+17,NA,439,439,NA,84,84,NA,355,355,NA,42
40,1,1.07105e+13,1.07105e+13,NA,412,412,NA,119,119,NA,293,293,NA,42
40,2,5.23019e+12,5.23019e+12,NA,408,408,NA,122,122,NA,286,286,NA,42
40,3,3.3331e+12,3.3331e+12,NA,514,514,NA,2,2,NA,512,512,NA,42
41,0,4.12268e+20,4.12268e+20,NA,413,413,NA,0,0,NA,413,413,NA,172
41,1,8.36975e+19,8.36975e+19,NA,466,466,NA,18,18,NA,448,448,NA,172
41,2,1.13795e+20,1.13795e+20,NA,479,479,NA,28,28,NA,451,451,NA,172
41,3,1.62367e+14,1.62367e+14,NA,581,581,NA,0,0,NA,581,581,NA,172
42,0,2.14221e+11,2.14221e+11,NA,227,227,NA,0,0,NA,227,227,NA,6
42,1,12438500000,12438500000,NA,227,227,NA,0,0,NA,227,227,NA,6
42,2,5482830000,5482830000,NA,223,223,NA,4,4,NA,219,219,NA,6
42,3,356551,356551,NA,227,227,NA,0,0,NA,227,227,NA,6
43,0,6.60542e+17,6.60542e+17,NA,460,460,NA,103,103,NA,357,357,NA,143
43,1,8.34732e+17,8.34732e+17,NA,469,469,NA,66,66,NA,403,403,NA,143
43,2,7.14922e+16,7.14922e+16,NA,476,476,NA,97,97,NA,379,379,NA,143
43,3,9.90789e+15,9.90789e+15,NA,662,662,NA,8,8,NA,654,654,NA,143
44,0,1.30118e+21,1.30118e+21,NA,444,444,NA,21,21,NA,423,423,NA,170
44,1,4.08715e+19,4.08715e+19,NA,445,445,NA,4,4,NA,441,441,NA,170
44,2,7.55513e+19,7.55513e+19,NA,479,479,NA,32,32,NA,447,447,NA,170
44,3,4.76451e+15,4.76451e+15,NA,641,641,NA,0,0,NA,641,641,NA,170
45,0,1.85121e+19,1.85121e+19,NA,398,398,NA,12,12,NA,386,386,NA,168
45,1,5.01604e+19,5.01604e+19,NA,459,459,NA,16,16,NA,443,443,NA,168
45,2,2.11483e+24,2.11483e+24,NA,567,567,NA,20,20,NA,547,547,NA,168
45,3,1.91015e+13,1.91015e+13,NA,547,547,NA,4,4,NA,543,543,NA,168
46,0,1.33703e+14,1.33703e+14,NA,327,327,NA,44,44,NA,283,283,NA,67
46,1,1.61321e+13,1.61321e+13,NA,318,318,NA,21,21,NA,297,297,NA,67
46,2,1.70023e+14,1.70023e+14,NA,392,392,NA,72,72,NA,320,320,NA,67
46,3,5.81606e+11,5.81606e+11,NA,488,488,NA,7,7,NA,481,481,NA,67
47,0,8.37731e+15,8.37731e+15,NA,354,354,NA,35,35,NA,319,319,NA,113
47,1,7.92008e+16,7.92008e+16,NA,412,412,NA,32,32,NA,380,380,NA,113
47,2,1.79195e+15,1.79195e+15,NA,411,411,NA,68,68,NA,343,343,NA,113
47,3,1.27953e+12,1.27953e+12,NA,521,521,NA,26,26,NA,495,495,NA,113
48,0,1.32668e+16,1.32668e+16,NA,373,373,NA,50,50,NA,323,323,NA,76
48,1,1.88356e+14,1.88356e+14,NA,369,369,NA,48,48,NA,321,321,NA,76
48,2,3.48178e+14,3.48178e+14,NA,451,451,NA,124,124,NA,327,327,NA,76
48,3,2.8332e+13,2.8332e+13,NA,552,552,NA,2,2,NA,550,550,NA,76
49,0,2.09288e+17,2.09288e+17,NA,377,377,NA,30,30,NA,347,347,NA,121
49,1,2.83701e+14,2.83701e+14,NA,344,344,NA,19,19,NA,325,325,NA,121
49,2,2.84463e+16,2.84463e+16,NA,382,382,NA,12,12,NA,370,370,NA,121
49,3,9.71769e+12,9.71769e+12,NA,539,539,NA,8,8,NA,531,531,NA,121
50,0,1.66955e+16,1.66955e+16,NA,357,357,NA,32,32,NA,325,325,NA,46
50,1,2.19332e+13,2.19332e+13,NA,409,409,NA,109,109,NA,300,300,NA,46
50,2,1.1258e+12,1.1258e+12,NA,390,390,NA,119,119,NA,271,271,NA,46
50,3,6.8866e+11,6.8866e+11,NA,488,488,NA,4,4,NA,484,484,NA,46
51,0,1.34745e+12,1.34745e+12,NA,315,315,NA,72,72,NA,243,243,NA,28
51,1,7.47448e+11,7.47448e+11,NA,305,305,NA,38,38,NA,267,267,NA,28
51,2,4.96249e+11,4.96249e+11,NA,311,311,NA,48,48,NA,263,263,NA,28
51,3,2559620,2559620,NA,280,280,NA,18,18,NA,262,262,NA,28
52,0,5.95722e+14,5.95722e+14,NA,308,308,NA,12,12,NA,296,296,NA,78
52,1,8.2804e+11,8.2804e+11,NA,275,275,NA,7,7,NA,268,268,NA,78
52,2,8.75053e+14,8.75053e+14,NA,342,342,NA,6,6,NA,336,336,NA,78
52,3,4.97582e+13,4.97582e+13,NA,564,564,NA,4,4,NA,560,560,NA,78
53,0,9.28884e+18,9.28884e+18,NA,452,452,NA,72,72,NA,380,380,NA,56
53,1,2.55402e+12,2.55402e+12,NA,410,410,NA,131,131,NA,279,279,NA,56
53,2,3.30357e+13,3.30357e+13,NA,418,418,NA,114,114,NA,304,304,NA,56
53,3,5.5332e+12,5.5332e+12,NA,521,521,NA,0,0,NA,521,521,NA,56
54,0,2.31161e+21,2.31161e+21,NA,428,428,NA,0,0,NA,428,428,NA,186
54,1,6.17258e+21,6.17258e+21,NA,490,490,NA,0,0,NA,490,490,NA,186
54,2,1.26404e+22,1.26404e+22,NA,497,497,NA,0,0,NA,497,497,NA,186
54,3,3.61852e+16,3.61852e+16,NA,677,677,NA,0,0,NA,677,677,NA,186
55,0,5.20831e+19,5.20831e+19,NA,399,399,NA,4,4,NA,395,395,NA,178
55,1,2.10917e+22,2.10917e+22,NA,510,510,NA,8,8,NA,502,502,NA,178
55,2,3.1683e+20,3.1683e+20,NA,488,488,NA,27,27,NA,461,461,NA,178
55,3,2.2224e+19,2.2224e+19,NA,819,819,NA,28,28,NA,791,791,NA,178
56,0,2.98916e+14,2.98916e+14,NA,296,296,NA,6,6,NA,290,290,NA,73
56,1,7.11096e+12,7.11096e+12,NA,291,291,NA,2,2,NA,289,289,NA,73
56,2,7.13007e+14,7.13007e+14,NA,340,340,NA,6,6,NA,334,334,NA,73
56,3,2161720,2161720,NA,261,261,NA,2,2,NA,259,259,NA,73
57,0,3.00079e+13,3.00079e+13,NA,313,313,NA,43,43,NA,270,270,NA,60
57,1,5.51233e+13,5.51233e+13,NA,331,331,NA,22,22,NA,309,309,NA,60
57,2,4.97582e+13,4.97582e+13,NA,349,349,NA,41,41,NA,308,308,NA,60
57,3,2.9398e+10,2.9398e+10,NA,451,451,NA,23,23,NA,428,428,NA,60
58,0,2.92033e+20,2.92033e+20,NA,445,445,NA,35,35,NA,410,410,NA,147
58,1,7.53489e+17,7.53489e+17,NA,606,606,NA,204,204,NA,402,402,NA,147
58,2,2.20512e+17,2.20512e+17,NA,509,509,NA,119,119,NA,390,390,NA,147
58,3,4.25697e+15,4.25697e+15,NA,699,699,NA,60,60,NA,639,639,NA,147
59,0,2.35692e+16,2.35692e+16,NA,342,342,NA,14,14,NA,328,328,NA,62
59,1,6.10668e+13,6.10668e+13,NA,317,317,NA,7,7,NA,310,310,NA,62
59,2,3.30357e+13,3.30357e+13,NA,329,329,NA,25,25,NA,304,304,NA,62
59,3,8.15419e+11,8.15419e+11,NA,505,505,NA,18,18,NA,487,487,NA,62
60,0,1.65021e+19,1.65021e+19,NA,400,400,NA,15,15,NA,385,385,NA,174
60,1,2.33032e+20,2.33032e+20,NA,488,488,NA,30,30,NA,458,458,NA,174
60,2,2.58158e+20,2.58158e+20,NA,482,482,NA,23,23,NA,459,459,NA,174
60,3,2004.12,2004.12,NA,135,135,NA,0,0,NA,135,135,NA,174
61,0,2.65429e+15,2.65429e+15,NA,311,311,NA,2,2,NA,309,309,NA,98
61,1,9.22257e+15,9.22257e+15,NA,361,361,NA,2,2,NA,359,359,NA,98
61,2,6.43611e+14,6.43611e+14,NA,350,350,NA,17,17,NA,333,333,NA,98
61,3,26266400000,26266400000,NA,427,427,NA,1,1,NA,426,426,NA,98
62,0,4.12268e+20,4.12268e+20,NA,470,470,NA,57,57,NA,413,413,NA,146
62,1,3.32135e+17,3.32135e+17,NA,457,457,NA,63,63,NA,394,394,NA,146
62,2,6.13954e+17,6.13954e+17,NA,491,491,NA,91,91,NA,400,400,NA,146
62,3,1.3891e+16,1.3891e+16,NA,664,664,NA,4,4,NA,660,660,NA,146
63,0,1.18724e+15,1.18724e+15,NA,348,348,NA,46,46,NA,302,302,NA,68
63,1,1.01896e+14,1.01896e+14,NA,353,353,NA,38,38,NA,315,315,NA,68
63,2,9.19786e+13,9.19786e+13,NA,365,365,NA,51,51,NA,314,314,NA,68
63,3,1.08763e+13,1.08763e+13,NA,549,549,NA,16,16,NA,533,533,NA,68
64,0,1.1554e+22,1.1554e+22,NA,492,492,NA,50,50,NA,442,442,NA,179
64,1,1.32509e+19,1.32509e+19,NA,446,446,NA,16,16,NA,430,430,NA,179
64,2,1.08261e+21,1.08261e+21,NA,499,499,NA,26,26,NA,473,473,NA,179
64,3,2.56432e+15,2.56432e+15,NA,630,630,NA,0,0,NA,630,630,NA,179
65,0,3.74709e+15,3.74709e+15,NA,335,335,NA,23,23,NA,312,312,NA,89
65,1,1.318e+15,1.318e+15,NA,352,352,NA,12,12,NA,340,340,NA,89
65,2,1.61321e+13,1.61321e+13,NA,311,311,NA,14,14,NA,297,297,NA,89
65,3,95929100000,95929100000,NA,449,449,NA,0,0,NA,449,449,NA,89
66,0,4.1872e+16,4.1872e+16,NA,364,364,NA,31,31,NA,333,333,NA,126
66,1,1.19292e+17,1.19292e+17,NA,432,432,NA,48,48,NA,384,384,NA,126
66,2,3.6696e+15,3.6696e+15,NA,403,403,NA,53,53,NA,350,350,NA,126
66,3,2.67805e+13,2.67805e+13,NA,554,554,NA,5,5,NA,549,549,NA,126
67,0,1.20582e+11,1.20582e+11,NA,238,238,NA,16,16,NA,222,222,NA,4
67,1,3285890000,3285890000,NA,241,241,NA,27,27,NA,214,214,NA,4
67,2,4467490000,4467490000,NA,239,239,NA,22,22,NA,217,217,NA,4
67,3,2864790,2864790,NA,264,264,NA,0,0,NA,264,264,NA,4
68,0,8.21624e+20,8.21624e+20,NA,429,429,NA,10,10,NA,419,419,NA,106
68,1,1.18972e+15,1.18972e+15,NA,354,354,NA,15,15,NA,339,339,NA,106
68,2,6.12309e+15,6.12309e+15,NA,390,390,NA,35,35,NA,355,355,NA,106
68,3,307018000,307018000,NA,514,514,NA,167,167,NA,347,347,NA,106
69,0,2.61338e+19,2.61338e+19,NA,490,490,NA,101,101,NA,389,389,NA,176
69,1,8.82125e+20,8.82125e+20,NA,566,566,NA,95,95,NA,471,471,NA,176
69,2,2.58158e+20,2.58158e+20,NA,614,614,NA,155,155,NA,459,459,NA,176
69,3,9.12637e+11,9.12637e+11,NA,501,501,NA,12,12,NA,489,489,NA,176
70,0,1.51745e+11,1.51745e+11,NA,266,266,NA,42,42,NA,224,224,NA,22
70,1,4.04351e+11,4.04351e+11,NA,301,301,NA,40,40,NA,261,261,NA,22
70,2,1.4523e+11,1.4523e+11,NA,281,281,NA,30,30,NA,251,251,NA,22
70,3,1.51505e+12,1.51505e+12,NA,540,540,NA,42,42,NA,498,498,NA,22
71,0,2.06062e+21,2.06062e+21,NA,450,450,NA,23,23,NA,427,427,NA,183
71,1,3.88837e+20,3.88837e+20,NA,499,499,NA,36,36,NA,463,463,NA,183
71,2,3.33922e+21,3.33922e+21,NA,524,524,NA,40,40,NA,484,484,NA,183
71,3,68422400000,68422400000,NA,494,494,NA,51,51,NA,443,443,NA,183
72,0,1.33703e+14,1.33703e+14,NA,307,307,NA,24,24,NA,283,283,NA,72
72,1,1.70023e+14,1.70023e+14,NA,350,350,NA,30,30,NA,320,320,NA,72
72,2,5.25833e+16,5.25833e+16,NA,426,426,NA,50,50,NA,376,376,NA,72
72,3,2.02081e+13,2.02081e+13,NA,556,556,NA,12,12,NA,544,544,NA,72
73,0,3.34025e+15,3.34025e+15,NA,328,328,NA,17,17,NA,311,311,NA,122
73,1,5.25833e+16,5.25833e+16,NA,433,433,NA,57,57,NA,376,376,NA,122
73,2,3.86756e+16,3.86756e+16,NA,429,429,NA,56,56,NA,373,373,NA,122
73,3,3.99794e+14,3.99794e+14,NA,609,609,NA,12,12,NA,597,597,NA,122
74,0,9.36125e+16,9.36125e+16,NA,349,349,NA,9,9,NA,340,340,NA,108
74,1,3.31245e+15,3.31245e+15,NA,357,357,NA,8,8,NA,349,349,NA,108
74,2,4.5036e+15,4.5036e+15,NA,377,377,NA,25,25,NA,352,352,NA,108
74,3,31101200000,31101200000,NA,435,435,NA,6,6,NA,429,429,NA,108
75,0,9.50777e+12,9.50777e+12,NA,260,260,NA,0,0,NA,260,260,NA,39
75,1,4.06527e+15,4.06527e+15,NA,351,351,NA,0,0,NA,351,351,NA,39
75,2,1.53064e+12,1.53064e+12,NA,274,274,NA,0,0,NA,274,274,NA,39
75,3,539202000,539202000,NA,357,357,NA,0,0,NA,357,357,NA,39
76,0,3.32731e+16,3.32731e+16,NA,344,344,NA,13,13,NA,331,331,NA,86
76,1,3.1429e+14,3.1429e+14,NA,340,340,NA,14,14,NA,326,326,NA,86
76,2,6.43611e+14,6.43611e+14,NA,336,336,NA,3,3,NA,333,333,NA,86
76,3,10667500000,10667500000,NA,444,444,NA,34,34,NA,410,410,NA,86
77,0,7.32416e+20,7.32416e+20,NA,515,515,NA,97,97,NA,418,418,NA,101
77,1,2.99005e+15,2.99005e+15,NA,478,478,NA,130,130,NA,348,348,NA,101
77,2,1.79195e+15,1.79195e+15,NA,453,453,NA,110,110,NA,343,343,NA,101
77,3,5.60516e+14,5.60516e+14,NA,603,603,NA,0,0,NA,603,603,NA,101
78,0,1.85841e+18,1.85841e+18,NA,367,367,NA,1,1,NA,366,366,NA,151
78,1,3.32135e+17,3.32135e+17,NA,412,412,NA,18,18,NA,394,394,NA,151
78,2,9.2722e+19,9.2722e+19,NA,451,451,NA,2,2,NA,449,449,NA,151
78,3,21757400,21757400,NA,308,308,NA,8,8,NA,300,300,NA,151
79,0,3.28877e+19,3.28877e+19,NA,410,410,NA,19,19,NA,391,391,NA,164
79,1,3.67946e+17,3.67946e+17,NA,410,410,NA,15,15,NA,395,395,NA,164
79,2,2.99005e+15,2.99005e+15,NA,364,364,NA,16,16,NA,348,348,NA,164
79,3,4.88926e+19,4.88926e+19,NA,830,830,NA,25,25,NA,805,805,NA,164
80,0,3.64662e+22,3.64662e+22,NA,513,513,NA,61,61,NA,452,452,NA,88
80,1,1.18972e+15,1.18972e+15,NA,469,469,NA,130,130,NA,339,339,NA,88
80,2,1.31447e+13,1.31447e+13,NA,446,446,NA,151,151,NA,295,295,NA,88
80,3,4.44577e+13,4.44577e+13,NA,562,562,NA,4,4,NA,558,558,NA,88
81,0,3.34025e+15,3.34025e+15,NA,333,333,NA,22,22,NA,311,311,NA,110
81,1,4.06527e+15,4.06527e+15,NA,375,375,NA,24,24,NA,351,351,NA,110
81,2,4.5036e+15,4.5036e+15,NA,371,371,NA,19,19,NA,352,352,NA,110
81,3,8.42193e+16,8.42193e+16,NA,701,701,NA,9,9,NA,692,692,NA,110
82,0,4.69721e+16,4.69721e+16,NA,496,496,NA,162,162,NA,334,334,NA,124
82,1,3.49113e+16,3.49113e+16,NA,450,450,NA,78,78,NA,372,372,NA,124
82,2,9.22257e+15,9.22257e+15,NA,500,500,NA,141,141,NA,359,359,NA,124
82,3,1.72887e+15,1.72887e+15,NA,623,623,NA,0,0,NA,623,623,NA,124
83,0,3.64662e+22,3.64662e+22,NA,470,470,NA,18,18,NA,452,452,NA,189
83,1,2.21699e+21,2.21699e+21,NA,498,498,NA,18,18,NA,480,480,NA,189
83,2,1.20579e+25,1.20579e+25,NA,582,582,NA,18,18,NA,564,564,NA,189
83,3,8.01233e+17,8.01233e+17,NA,750,750,NA,18,18,NA,732,732,NA,189
84,0,1.8875e+14,1.8875e+14,NA,313,313,NA,27,27,NA,286,286,NA,51
84,1,2.19332e+13,2.19332e+13,NA,322,322,NA,22,22,NA,300,300,NA,51
84,2,1.18653e+13,1.18653e+13,NA,313,313,NA,19,19,NA,294,294,NA,51
84,3,1861410000,1861410000,NA,381,381,NA,2,2,NA,379,379,NA,51
85,0,1.16894e+19,1.16894e+19,NA,382,382,NA,0,0,NA,382,382,NA,160
85,1,9.72008e+16,9.72008e+16,NA,382,382,NA,0,0,NA,382,382,NA,160
85,2,4.08715e+19,4.08715e+19,NA,461,461,NA,20,20,NA,441,441,NA,160
85,3,2204040000,2204040000,NA,382,382,NA,0,0,NA,382,382,NA,160
86,0,7.49678e+14,7.49678e+14,NA,313,313,NA,15,15,NA,298,298,NA,82
86,1,3.6696e+15,3.6696e+15,NA,371,371,NA,21,21,NA,350,350,NA,82
86,2,1.78715e+13,1.78715e+13,NA,384,384,NA,86,86,NA,298,298,NA,82
86,3,5.81606e+11,5.81606e+11,NA,500,500,NA,19,19,NA,481,481,NA,82
87,0,8.50843e+11,8.50843e+11,NA,248,248,NA,9,9,NA,239,239,NA,1
87,1,44555200,44555200,NA,192,192,NA,20,20,NA,172,172,NA,1
87,2,54681300,54681300,NA,218,218,NA,44,44,NA,174,174,NA,1
87,3,25762200,25762200,NA,310,310,NA,7,7,NA,303,303,NA,1
88,0,2.93169e+19,2.93169e+19,NA,430,430,NA,40,40,NA,390,390,NA,157
88,1,1.39283e+18,1.39283e+18,NA,442,442,NA,34,34,NA,408,408,NA,157
88,2,2.57467e+18,2.57467e+18,NA,442,442,NA,28,28,NA,414,414,NA,157
88,3,3.2903e+10,3.2903e+10,NA,464,464,NA,34,34,NA,430,430,NA,157
89,0,7.52595e+13,7.52595e+13,NA,299,299,NA,21,21,NA,278,278,NA,64
89,1,1.70023e+14,1.70023e+14,NA,340,340,NA,20,20,NA,320,320,NA,64
89,2,5.51233e+13,5.51233e+13,NA,343,343,NA,34,34,NA,309,309,NA,64
89,3,2.37736e+12,2.37736e+12,NA,523,523,NA,17,17,NA,506,506,NA,64
90,0,2.68538e+12,2.68538e+12,NA,257,257,NA,8,8,NA,249,249,NA,33
90,1,2.08106e+12,2.08106e+12,NA,346,346,NA,69,69,NA,277,277,NA,33
90,2,1.70023e+14,1.70023e+14,NA,349,349,NA,29,29,NA,320,320,NA,33
90,3,23468400000,23468400000,NA,450,450,NA,26,26,NA,424,424,NA,33
91,0,4.23626e+13,4.23626e+13,NA,273,273,NA,0,0,NA,273,273,NA,27
91,1,6.09032e+11,6.09032e+11,NA,296,296,NA,31,31,NA,265,265,NA,27
91,2,4.96249e+11,4.96249e+11,NA,294,294,NA,31,31,NA,263,263,NA,27
91,3,45244800,45244800,NA,320,320,NA,7,7,NA,313,313,NA,27
92,0,1.67604e+15,1.67604e+15,NA,327,327,NA,22,22,NA,305,305,NA,77
92,1,7.49456e+13,7.49456e+13,NA,381,381,NA,69,69,NA,312,312,NA,77
92,2,5.24424e+14,5.24424e+14,NA,419,419,NA,88,88,NA,331,331,NA,77
92,3,3144.79,3144.79,NA,143,143,NA,0,0,NA,143,143,NA,77
93,0,3.68935e+19,3.68935e+19,NA,399,399,NA,7,7,NA,392,392,NA,166
93,1,1.62625e+19,1.62625e+19,NA,542,542,NA,110,110,NA,432,432,NA,166
93,2,3.1683e+20,3.1683e+20,NA,484,484,NA,23,23,NA,461,461,NA,166
93,3,5.1392e+18,5.1392e+18,NA,779,779,NA,14,14,NA,765,765,NA,166
94,0,1.31132e+19,1.31132e+19,NA,412,412,NA,29,29,NA,383,383,NA,190
94,1,7.20701e+22,7.20701e+22,NA,527,527,NA,13,13,NA,514,514,NA,190
94,2,1.54301e+18,1.54301e+18,NA,460,460,NA,51,51,NA,409,409,NA,190
94,3,4.77326e+24,4.77326e+24,NA,1021,1021,NA,12,12,NA,1009,1009,NA,190
95,0,2.12564e+13,2.12564e+13,NA,282,282,NA,15,15,NA,267,267,NA,53
95,1,4.05438e+13,4.05438e+13,NA,358,358,NA,52,52,NA,306,306,NA,53
95,2,1.61321e+13,1.61321e+13,NA,349,349,NA,52,52,NA,297,297,NA,53
95,3,81016700000,81016700000,NA,459,459,NA,13,13,NA,446,446,NA,53
96,0,4.21985e+14,4.21985e+14,NA,293,293,NA,0,0,NA,293,293,NA,79
96,1,1.07393e+15,1.07393e+15,NA,346,346,NA,8,8,NA,338,338,NA,79
96,2,2.56089e+14,2.56089e+14,NA,354,354,NA,30,30,NA,324,324,NA,79
96,3,2043340,2043340,NA,286,286,NA,28,28,NA,258,258,NA,79
97,0,1.67604e+15,1.67604e+15,NA,357,357,NA,52,52,NA,305,305,NA,70
97,1,1.70023e+14,1.70023e+14,NA,342,342,NA,22,22,NA,320,320,NA,70
97,2,4.49153e+13,4.49153e+13,NA,365,365,NA,58,58,NA,307,307,NA,70
97,3,1.79392e+12,1.79392e+12,NA,507,507,NA,6,6,NA,501,501,NA,70
98,0,2.07669e+19,2.07669e+19,NA,388,388,NA,1,1,NA,387,387,NA,155
98,1,2.56777e+16,2.56777e+16,NA,370,370,NA,1,1,NA,369,369,NA,155
98,2,2.57467e+18,2.57467e+18,NA,416,416,NA,2,2,NA,414,414,NA,155
98,3,3.97219e+13,3.97219e+13,NA,559,559,NA,3,3,NA,556,556,NA,155
99,0,4.75224e+13,4.75224e+13,NA,292,292,NA,18,18,NA,274,274,NA,95
99,1,1.2539e+16,1.2539e+16,NA,408,408,NA,46,46,NA,362,362,NA,95
99,2,2.99005e+15,2.99005e+15,NA,401,401,NA,53,53,NA,348,348,NA,95
99,3,1.43208e+12,1.43208e+12,NA,499,499,NA,2,2,NA,497,497,NA,95
100,0,1.47676e+18,1.47676e+18,NA,399,399,NA,35,35,NA,364,364,NA,102
100,1,1.79195e+15,1.79195e+15,NA,344,344,NA,1,1,NA,343,343,NA,102
100,2,4.06527e+15,4.06527e+15,NA,419,419,NA,68,68,NA,351,351,NA,102
100,3,1.29617e+14,1.29617e+14,NA,584,584,NA,7,7,NA,577,577,NA,102
101,0,5.24891e+17,5.24891e+17,NA,433,433,NA,78,78,NA,355,355,NA,141
101,1,1.62189e+17,1.62189e+17,NA,430,430,NA,43,43,NA,387,387,NA,141
101,2,9.24735e+17,9.24735e+17,NA,445,445,NA,41,41,NA,404,404,NA,141
101,3,6.93124e+12,6.93124e+12,NA,527,527,NA,2,2,NA,525,525,NA,141
102,0,8.47546e+12,8.47546e+12,NA,263,263,NA,4,4,NA,259,259,NA,45
102,1,2.83701e+14,2.83701e+14,NA,337,337,NA,12,12,NA,325,325,NA,45
102,2,1.4562e+13,1.4562e+13,NA,300,300,NA,4,4,NA,296,296,NA,45
102,3,539202000,539202000,NA,357,357,NA,0,0,NA,357,357,NA,45
103,0,1.68911e+13,1.68911e+13,NA,281,281,NA,16,16,NA,265,265,NA,71
103,1,2.56089e+14,2.56089e+14,NA,343,343,NA,19,19,NA,324,324,NA,71
103,2,4.28457e+16,4.28457e+16,NA,386,386,NA,12,12,NA,374,374,NA,71
103,3,8515830000,8515830000,NA,417,417,NA,11,11,NA,406,406,NA,71
104,0,9.21699e+20,9.21699e+20,NA,455,455,NA,35,35,NA,420,420,NA,193
104,1,9.32209e+23,9.32209e+23,NA,570,570,NA,31,31,NA,539,539,NA,193
104,2,4.09813e+21,4.09813e+21,NA,564,564,NA,78,78,NA,486,486,NA,193
104,3,1.04335e+24,1.04335e+24,NA,983,983,NA,1,1,NA,982,982,NA,193
105,0,2.08477e+18,2.08477e+18,NA,374,374,NA,7,7,NA,367,367,NA,134
105,1,7.5147e+15,7.5147e+15,NA,364,364,NA,7,7,NA,357,357,NA,134
105,2,1.19292e+17,1.19292e+17,NA,428,428,NA,44,44,NA,384,384,NA,134
105,3,1.51505e+12,1.51505e+12,NA,508,508,NA,10,10,NA,498,498,NA,134
106,0,8.4099e+14,8.4099e+14,NA,416,416,NA,117,117,NA,299,299,NA,128
106,1,2.09788e+18,2.09788e+18,NA,426,426,NA,14,14,NA,412,412,NA,128
106,2,5.25833e+16,5.25833e+16,NA,396,396,NA,20,20,NA,376,376,NA,128
106,3,5.85376e+12,5.85376e+12,NA,610,610,NA,88,88,NA,522,522,NA,128
107,0,2.06062e+21,2.06062e+21,NA,470,470,NA,43,43,NA,427,427,NA,181
107,1,5.30083e+22,5.30083e+22,NA,511,511,NA,0,0,NA,511,511,NA,181
107,2,4.4795e+11,4.4795e+11,NA,389,389,NA,127,127,NA,262,262,NA,181
107,3,3.15057e+12,3.15057e+12,NA,511,511,NA,0,0,NA,511,511,NA,181
108,0,1.48251e+17,1.48251e+17,NA,374,374,NA,30,30,NA,344,344,NA,130
108,1,2.56777e+16,2.56777e+16,NA,406,406,NA,37,37,NA,369,369,NA,130
108,2,3.49113e+16,3.49113e+16,NA,439,439,NA,67,67,NA,372,372,NA,130
108,3,2.56432e+15,2.56432e+15,NA,639,639,NA,9,9,NA,630,630,NA,130
109,0,2.92033e+20,2.92033e+20,NA,452,452,NA,42,42,NA,410,410,NA,171
109,1,1.54716e+20,1.54716e+20,NA,468,468,NA,14,14,NA,454,454,NA,171
109,2,1.7048e+16,1.7048e+16,NA,384,384,NA,19,19,NA,365,365,NA,171
109,3,1.27129e+11,1.27129e+11,NA,468,468,NA,14,14,NA,454,454,NA,171
110,0,1.67604e+15,1.67604e+15,NA,359,359,NA,54,54,NA,305,305,NA,94
110,1,2.84463e+16,2.84463e+16,NA,437,437,NA,67,67,NA,370,370,NA,94
110,2,1.18972e+15,1.18972e+15,NA,406,406,NA,67,67,NA,339,339,NA,94
110,3,16102.5,16102.5,NA,179,179,NA,7,7,NA,172,172,NA,94
111,0,2.34779e+17,2.34779e+17,NA,384,384,NA,36,36,NA,348,348,NA,137
111,1,1.7048e+16,1.7048e+16,NA,371,371,NA,6,6,NA,365,365,NA,137
111,2,8.86872e+24,8.86872e+24,NA,623,623,NA,62,62,NA,561,561,NA,137
111,3,3.19155e+14,3.19155e+14,NA,629,629,NA,36,36,NA,593,593,NA,137
112,0,1.61849e+24,1.61849e+24,NA,491,491,NA,6,6,NA,485,485,NA,180
112,1,1.62625e+19,1.62625e+19,NA,445,445,NA,13,13,NA,432,432,NA,180
112,2,6.8198e+19,6.8198e+19,NA,455,455,NA,9,9,NA,446,446,NA,180
112,3,1.21168e+21,1.21168e+21,NA,881,881,NA,19,19,NA,862,862,NA,180
113,0,7.52595e+13,7.52595e+13,NA,312,312,NA,34,34,NA,278,278,NA,7
113,1,16911300000,16911300000,NA,252,252,NA,22,22,NA,230,230,NA,7
113,2,783552000,783552000,NA,241,241,NA,41,41,NA,200,200,NA,7
113,3,2204040000,2204040000,NA,409,409,NA,27,27,NA,382,382,NA,7
114,0,1.88018e+15,1.88018e+15,NA,322,322,NA,16,16,NA,306,306,NA,93
114,1,9.22257e+15,9.22257e+15,NA,366,366,NA,7,7,NA,359,359,NA,93
114,2,5.80969e+14,5.80969e+14,NA,354,354,NA,22,22,NA,332,332,NA,93
114,3,4.47459e+14,4.47459e+14,NA,606,606,NA,7,7,NA,599,599,NA,93
115,0,3.71811e+17,3.71811e+17,NA,361,361,NA,9,9,NA,352,352,NA,138
115,1,9.77239e+20,9.77239e+20,NA,481,481,NA,9,9,NA,472,472,NA,138
115,2,2.09226e+16,2.09226e+16,NA,376,376,NA,9,9,NA,367,367,NA,138
115,3,2.66081e+12,2.66081e+12,NA,517,517,NA,9,9,NA,508,508,NA,138
116,0,5.84268e+19,5.84268e+19,NA,472,472,NA,76,76,NA,396,396,NA,74
116,1,3.48178e+14,3.48178e+14,NA,446,446,NA,119,119,NA,327,327,NA,74
116,2,7.11096e+12,7.11096e+12,NA,423,423,NA,134,134,NA,289,289,NA,74
116,3,1.44136e+13,1.44136e+13,NA,543,543,NA,5,5,NA,538,538,NA,74
117,0,5.88823e+17,5.88823e+17,NA,356,356,NA,0,0,NA,356,356,NA,84
117,1,4.73383e+14,4.73383e+14,NA,346,346,NA,16,16,NA,330,330,NA,84
117,2,4.27309e+14,4.27309e+14,NA,358,358,NA,29,29,NA,329,329,NA,84
117,3,1.08062e+12,1.08062e+12,NA,492,492,NA,0,0,NA,492,492,NA,84
118,0,12105100000,12105100000,NA,202,202,NA,0,0,NA,202,202,NA,2
118,1,961632000,961632000,NA,202,202,NA,0,0,NA,202,202,NA,2
118,2,961632000,961632000,NA,202,202,NA,0,0,NA,202,202,NA,2
118,3,87227.8,87227.8,NA,202,202,NA,0,0,NA,202,202,NA,2
119,0,2.27599e+25,2.27599e+25,NA,528,528,NA,20,20,NA,508,508,NA,199
119,1,2.12621e+28,2.12621e+28,NA,637,637,NA,0,0,NA,637,637,NA,199
119,2,8.46006e+27,8.46006e+27,NA,650,650,NA,22,22,NA,628,628,NA,199
119,3,16.7084,16.7084,NA,50,50,NA,0,0,NA,50,50,NA,199
120,0,1.14202e+25,1.14202e+25,NA,624,624,NA,122,122,NA,502,502,NA,169
120,1,1.19612e+19,1.19612e+19,NA,432,432,NA,3,3,NA,429,429,NA,169
120,2,9.7462e+18,9.7462e+18,NA,519,519,NA,92,92,NA,427,427,NA,169
120,3,9.61053e+19,9.61053e+19,NA,820,820,NA,3,3,NA,817,817,NA,169
121,0,5.86541e+18,5.86541e+18,NA,413,413,NA,37,37,NA,376,376,NA,40
121,1,1.07105e+13,1.07105e+13,NA,381,381,NA,88,88,NA,293,293,NA,40
121,2,4.04351e+11,4.04351e+11,NA,361,361,NA,100,100,NA,261,261,NA,40
121,3,95929100000,95929100000,NA,449,449,NA,0,0,NA,449,449,NA,40
122,0,1.48827e+16,1.48827e+16,NA,362,362,NA,38,38,NA,324,324,NA,118
122,1,2.84463e+16,2.84463e+16,NA,424,424,NA,54,54,NA,370,370,NA,118
122,2,3.6696e+15,3.6696e+15,NA,402,402,NA,52,52,NA,350,350,NA,118
122,3,2043340,2043340,NA,258,258,NA,0,0,NA,258,258,NA,118
123,0,4.1872e+16,4.1872e+16,NA,374,374,NA,41,41,NA,333,333,NA,83
123,1,4.27309e+14,4.27309e+14,NA,365,365,NA,36,36,NA,329,329,NA,83
123,2,3.48178e+14,3.48178e+14,NA,389,389,NA,62,62,NA,327,327,NA,83
123,3,9.78068e+13,9.78068e+13,NA,611,611,NA,39,39,NA,572,572,NA,83
124,0,4.67901e+17,4.67901e+17,NA,358,358,NA,4,4,NA,354,354,NA,163
124,1,2.44945e+19,2.44945e+19,NA,439,439,NA,3,3,NA,436,436,NA,163
124,2,7.96269e+20,7.96269e+20,NA,489,489,NA,19,19,NA,470,470,NA,163
124,3,2.43961e+16,2.43961e+16,NA,672,672,NA,2,2,NA,670,670,NA,163
125,0,4.50082e+27,4.50082e+27,NA,556,556,NA,2,2,NA,554,554,NA,197
125,1,6.20579e+25,6.20579e+25,NA,582,582,NA,2,2,NA,580,580,NA,197
125,2,5.04303e+23,5.04303e+23,NA,535,535,NA,2,2,NA,533,533,NA,197
125,3,6.35504e+16,6.35504e+16,NA,689,689,NA,2,2,NA,687,687,NA,197
126,0,5.22857e+18,5.22857e+18,NA,401,401,NA,26,26,NA,375,375,NA,25
126,1,1.06818e+11,1.06818e+11,NA,345,345,NA,97,97,NA,248,248,NA,25
126,2,6.747e+11,6.747e+11,NA,352,352,NA,86,86,NA,266,266,NA,25
126,3,15822400000,15822400000,NA,421,421,NA,4,4,NA,417,417,NA,25
127,0,1.04608e+18,1.04608e+18,NA,459,459,NA,98,98,NA,361,361,NA,139
127,1,3.67946e+17,3.67946e+17,NA,478,478,NA,83,83,NA,395,395,NA,139
127,2,2.20512e+17,2.20512e+17,NA,430,430,NA,40,40,NA,390,390,NA,139
127,3,1.52487e+13,1.52487e+13,NA,622,622,NA,83,83,NA,539,539,NA,139
128,0,1.13319e+27,1.13319e+27,NA,622,622,NA,80,80,NA,542,542,NA,198
128,1,3.19391e+26,3.19391e+26,NA,696,696,NA,100,100,NA,596,596,NA,198
128,2,1.55966e+26,1.55966e+26,NA,675,675,NA,86,86,NA,589,589,NA,198
128,3,1.33255e+27,1.33255e+27,NA,1191,1191,NA,82,82,NA,1109,1109,NA,198
129,0,5.91114e+16,5.91114e+16,NA,372,372,NA,36,36,NA,336,336,NA,52
129,1,2.98204e+13,2.98204e+13,NA,356,356,NA,53,53,NA,303,303,NA,52
129,2,4.72114e+12,4.72114e+12,NA,347,347,NA,62,62,NA,285,285,NA,52
129,3,8049490000,8049490000,NA,405,405,NA,0,0,NA,405,405,NA,52
130,0,4.71548e+15,4.71548e+15,NA,408,408,NA,94,94,NA,314,314,NA,149
130,1,4.30762e+20,4.30762e+20,NA,532,532,NA,68,68,NA,464,464,NA,149
130,2,1.02444e+18,1.02444e+18,NA,507,507,NA,102,102,NA,405,405,NA,149
130,3,8.85246e+15,8.85246e+15,NA,679,679,NA,27,27,NA,652,652,NA,149
131,0,2.36609e+15,2.36609e+15,NA,309,309,NA,1,1,NA,308,308,NA,125
131,1,1.32509e+19,1.32509e+19,NA,431,431,NA,1,1,NA,430,430,NA,125
131,2,4.28457e+16,4.28457e+16,NA,375,375,NA,1,1,NA,374,374,NA,125
131,3,1.2173e+13,1.2173e+13,NA,537,537,NA,2,2,NA,535,535,NA,125
132,0,2.93169e+19,2.93169e+19,NA,457,457,NA,67,67,NA,390,390,NA,165
132,1,3.88837e+20,3.88837e+20,NA,632,632,NA,169,169,NA,463,463,NA,165
132,2,7.16843e+18,7.16843e+18,NA,515,515,NA,91,91,NA,424,424,NA,165
132,3,1.56479e+17,1.56479e+17,NA,710,710,NA,7,7,NA,703,703,NA,165
133,0,8.44261e+13,8.44261e+13,NA,280,280,NA,1,1,NA,279,279,NA,59
133,1,6.76512e+13,6.76512e+13,NA,313,313,NA,2,2,NA,311,311,NA,59
133,2,4.72114e+12,4.72114e+12,NA,286,286,NA,1,1,NA,285,285,NA,59
133,3,43604300000,43604300000,NA,437,437,NA,2,2,NA,435,435,NA,59
134,0,3.00079e+13,3.00079e+13,NA,308,308,NA,38,38,NA,270,270,NA,36
134,1,8.72708e+12,8.72708e+12,NA,332,332,NA,41,41,NA,291,291,NA,36
134,2,6.09032e+11,6.09032e+11,NA,313,313,NA,48,48,NA,265,265,NA,36
134,3,34141000,34141000,NA,376,376,NA,68,68,NA,308,308,NA,36
135,0,6.65692e+15,6.65692e+15,NA,477,477,NA,160,160,NA,317,317,NA,109
135,1,1.25727e+18,1.25727e+18,NA,529,529,NA,122,122,NA,407,407,NA,109
135,2,1.18972e+15,1.18972e+15,NA,484,484,NA,145,145,NA,339,339,NA,109
135,3,1.45071e+14,1.45071e+14,NA,579,579,NA,0,0,NA,579,579,NA,109
136,0,1.16441e+20,1.16441e+20,NA,419,419,NA,17,17,NA,402,402,NA,182
136,1,3.33027e+19,3.33027e+19,NA,458,458,NA,19,19,NA,439,439,NA,182
136,2,2.21699e+21,2.21699e+21,NA,524,524,NA,44,44,NA,480,480,NA,182
136,3,3.73734e+21,3.73734e+21,NA,889,889,NA,7,7,NA,882,882,NA,182
137,0,5.70815e+25,5.70815e+25,NA,586,586,NA,70,70,NA,516,516,NA,150
137,1,1.02444e+18,1.02444e+18,NA,578,578,NA,173,173,NA,405,405,NA,150
137,2,4.5157e+17,4.5157e+17,NA,543,543,NA,146,146,NA,397,397,NA,150
137,3,1.82903e+15,1.82903e+15,NA,624,624,NA,0,0,NA,624,624,NA,150
138,0,1.16894e+19,1.16894e+19,NA,422,422,NA,40,40,NA,382,382,NA,154
138,1,1.318e+15,1.318e+15,NA,392,392,NA,52,52,NA,340,340,NA,154
138,2,2.57467e+18,2.57467e+18,NA,446,446,NA,32,32,NA,414,414,NA,154
138,3,1.02807e+13,1.02807e+13,NA,577,577,NA,45,45,NA,532,532,NA,154
139,0,3.64662e+22,3.64662e+22,NA,461,461,NA,9,9,NA,452,452,NA,152
139,1,2.09788e+18,2.09788e+18,NA,441,441,NA,29,29,NA,412,412,NA,152
139,2,3.32135e+17,3.32135e+17,NA,434,434,NA,40,40,NA,394,394,NA,152
139,3,1.13586e+11,1.13586e+11,NA,461,461,NA,9,9,NA,452,452,NA,152
140,0,2.92033e+20,2.92033e+20,NA,419,419,NA,9,9,NA,410,410,NA,184
140,1,4.3192e+22,4.3192e+22,NA,536,536,NA,27,27,NA,509,509,NA,184
140,2,6.17258e+21,6.17258e+21,NA,508,508,NA,18,18,NA,490,490,NA,184
140,3,2.4989e+11,2.4989e+11,NA,466,466,NA,0,0,NA,466,466,NA,184
141,0,3.34025e+15,3.34025e+15,NA,325,325,NA,14,14,NA,311,311,NA,104
141,1,2.69903e+15,2.69903e+15,NA,380,380,NA,33,33,NA,347,347,NA,104
141,2,1.98517e+15,1.98517e+15,NA,357,357,NA,13,13,NA,344,344,NA,104
141,3,1.57494e+18,1.57494e+18,NA,769,769,NA,25,25,NA,744,744,NA,104
142,0,2.08477e+18,2.08477e+18,NA,369,369,NA,2,2,NA,367,367,NA,158
142,1,4.08715e+19,4.08715e+19,NA,443,443,NA,2,2,NA,441,441,NA,158
142,2,2.57467e+18,2.57467e+18,NA,428,428,NA,14,14,NA,414,414,NA,158
142,3,8.62659e+11,8.62659e+11,NA,498,498,NA,10,10,NA,488,488,NA,158
143,0,1.61849e+24,1.61849e+24,NA,486,486,NA,1,1,NA,485,485,NA,194
143,1,9.29711e+21,9.29711e+21,NA,495,495,NA,1,1,NA,494,494,NA,194
143,2,1.27425e+28,1.27425e+28,NA,638,638,NA,6,6,NA,632,632,NA,194
143,3,1.41629e+19,1.41629e+19,NA,784,784,NA,1,1,NA,783,783,NA,194
144,0,2.06062e+21,2.06062e+21,NA,485,485,NA,58,58,NA,427,427,NA,75
144,1,3.48178e+14,3.48178e+14,NA,440,440,NA,113,113,NA,327,327,NA,75
144,2,3.30357e+13,3.30357e+13,NA,430,430,NA,126,126,NA,304,304,NA,75
144,3,1.28782e+13,1.28782e+13,NA,536,536,NA,0,0,NA,536,536,NA,75
145,0,9.39767e+15,9.39767e+15,NA,320,320,NA,0,0,NA,320,320,NA,112
145,1,1.70938e+18,1.70938e+18,NA,410,410,NA,0,0,NA,410,410,NA,112
145,2,3.48178e+14,3.48178e+14,NA,332,332,NA,5,5,NA,327,327,NA,112
145,3,3.73048e+12,3.73048e+12,NA,514,514,NA,0,0,NA,514,514,NA,112
146,0,1.66308e+17,1.66308e+17,NA,366,366,NA,21,21,NA,345,345,NA,103
146,1,4.98919e+15,4.98919e+15,NA,361,361,NA,8,8,NA,353,353,NA,103
146,2,8.75053e+14,8.75053e+14,NA,380,380,NA,44,44,NA,336,336,NA,103
146,3,2466810000,2466810000,NA,388,388,NA,4,4,NA,384,384,NA,103
147,0,5.28983e+15,5.28983e+15,NA,316,316,NA,1,1,NA,315,315,NA,119
147,1,1.53888e+16,1.53888e+16,NA,365,365,NA,1,1,NA,364,364,NA,119
147,2,9.7462e+18,9.7462e+18,NA,428,428,NA,1,1,NA,427,427,NA,119
147,3,206992000,206992000,NA,341,341,NA,1,1,NA,340,340,NA,119
148,0,6813820000,6813820000,NA,209,209,NA,12,12,NA,197,197,NA,3
148,1,1604580000,1604580000,NA,217,217,NA,10,10,NA,207,207,NA,3
148,2,638451000,638451000,NA,248,248,NA,50,50,NA,198,198,NA,3
148,3,13865500,13865500,NA,292,292,NA,0,0,NA,292,292,NA,3
149,0,2.33869e+18,2.33869e+18,NA,376,376,NA,8,8,NA,368,368,NA,153
149,1,2.20512e+17,2.20512e+17,NA,410,410,NA,20,20,NA,390,390,NA,153
149,2,9.2722e+19,9.2722e+19,NA,457,457,NA,8,8,NA,449,449,NA,153
149,3,6.63689e+14,6.63689e+14,NA,606,606,NA,0,0,NA,606,606,NA,153
150,0,1.05015e+17,1.05015e+17,NA,413,413,NA,72,72,NA,341,341,NA,177
150,1,1.55548e+24,1.55548e+24,NA,544,544,NA,0,0,NA,544,544,NA,177
150,2,3.50992e+20,3.50992e+20,NA,494,494,NA,32,32,NA,462,462,NA,177
150,3,32271300,32271300,NA,331,331,NA,24,24,NA,307,307,NA,177
151,0,7.43879e+16,7.43879e+16,NA,354,354,NA,16,16,NA,338,338,NA,107
151,1,2.69903e+15,2.69903e+15,NA,377,377,NA,30,30,NA,347,347,NA,107
151,2,4.98919e+15,4.98919e+15,NA,442,442,NA,89,89,NA,353,353,NA,107
151,3,2.2764e+14,2.2764e+14,NA,596,596,NA,9,9,NA,587,587,NA,107
152,0,9.18127e+21,9.18127e+21,NA,440,440,NA,0,0,NA,440,440,NA,187
152,1,2.00121e+21,2.00121e+21,NA,479,479,NA,0,0,NA,479,479,NA,187
152,2,6.83813e+21,6.83813e+21,NA,491,491,NA,0,0,NA,491,491,NA,187
152,3,2.58095e+16,2.58095e+16,NA,671,671,NA,0,0,NA,671,671,NA,187
153,0,5.28983e+15,5.28983e+15,NA,329,329,NA,14,14,NA,315,315,NA,30
153,1,7.47448e+11,7.47448e+11,NA,277,277,NA,10,10,NA,267,267,NA,30
153,2,6.09032e+11,6.09032e+11,NA,291,291,NA,26,26,NA,265,265,NA,30
153,3,27788100000,27788100000,NA,439,439,NA,12,12,NA,427,427,NA,30
154,0,2.06864e+20,2.06864e+20,NA,431,431,NA,24,24,NA,407,407,NA,48
154,1,5.23019e+12,5.23019e+12,NA,376,376,NA,90,90,NA,286,286,NA,48
154,2,2.42981e+13,2.42981e+13,NA,383,383,NA,82,82,NA,301,301,NA,48
154,3,68422400000,68422400000,NA,449,449,NA,6,6,NA,443,443,NA,48
155,0,1.06658e+13,1.06658e+13,NA,285,285,NA,24,24,NA,261,261,NA,41
155,1,1.87851e+12,1.87851e+12,NA,291,291,NA,15,15,NA,276,276,NA,41
155,2,2.6918e+13,2.6918e+13,NA,308,308,NA,6,6,NA,302,302,NA,41
155,3,46130400000,46130400000,NA,437,437,NA,1,1,NA,436,436,NA,41
156,0,5.08838e+25,5.08838e+25,NA,516,516,NA,1,1,NA,515,515,NA,188
156,1,1.19934e+21,1.19934e+21,NA,479,479,NA,5,5,NA,474,474,NA,188
156,2,2.10917e+22,2.10917e+22,NA,503,503,NA,1,1,NA,502,502,NA,188
156,3,1.42547e+20,1.42547e+20,NA,825,825,NA,1,1,NA,824,824,NA,188
157,0,1.79459e+27,1.79459e+27,NA,553,553,NA,7,7,NA,546,546,NA,200
157,1,7.18769e+20,7.18769e+20,NA,476,476,NA,7,7,NA,469,469,NA,200
157,2,4.82358e+28,4.82358e+28,NA,658,658,NA,13,13,NA,645,645,NA,200
157,3,1.04527e+33,1.04527e+33,NA,1368,1368,NA,18,18,NA,1350,1350,NA,200
158,0,7.46773e+15,7.46773e+15,NA,349,349,NA,31,31,NA,318,318,NA,115
158,1,1.62189e+17,1.62189e+17,NA,400,400,NA,13,13,NA,387,387,NA,115
158,2,3.31245e+15,3.31245e+15,NA,416,416,NA,67,67,NA,349,349,NA,115
158,3,2.24718e+12,2.24718e+12,NA,572,572,NA,67,67,NA,505,505,NA,115
159,0,4.25274e+12,4.25274e+12,NA,253,253,NA,0,0,NA,253,253,NA,32
159,1,4.49153e+13,4.49153e+13,NA,326,326,NA,19,19,NA,307,307,NA,32
159,2,3.29472e+11,3.29472e+11,NA,259,259,NA,0,0,NA,259,259,NA,32
159,3,2760920000,2760920000,NA,386,386,NA,0,0,NA,386,386,NA,32
160,0,1.85121e+19,1.85121e+19,NA,426,426,NA,40,40,NA,386,386,NA,127
160,1,8.32495e+15,8.32495e+15,NA,412,412,NA,54,54,NA,358,358,NA,127
160,2,3.86756e+16,3.86756e+16,NA,516,516,NA,143,143,NA,373,373,NA,127
160,3,3.77901e+14,3.77901e+14,NA,618,618,NA,22,22,NA,596,596,NA,127
161,0,2.5532e+25,2.5532e+25,NA,604,604,NA,95,95,NA,509,509,NA,196
161,1,1.63939e+25,1.63939e+25,NA,677,677,NA,110,110,NA,567,567,NA,196
161,2,8.00554e+24,8.00554e+24,NA,664,664,NA,104,104,NA,560,560,NA,196
161,3,2.73549e+25,2.73549e+25,NA,1142,1142,NA,102,102,NA,1040,1040,NA,196
162,0,9.54476e+11,9.54476e+11,NA,248,248,NA,8,8,NA,240,240,NA,37
162,1,1.25054e+14,1.25054e+14,NA,325,325,NA,8,8,NA,317,317,NA,37
162,2,8.72708e+12,8.72708e+12,NA,303,303,NA,12,12,NA,291,291,NA,37
162,3,8.15419e+11,8.15419e+11,NA,491,491,NA,4,4,NA,487,487,NA,37
163,0,1.19186e+14,1.19186e+14,NA,378,378,NA,96,96,NA,282,282,NA,85
163,1,2.31785e+16,2.31785e+16,NA,415,415,NA,47,47,NA,368,368,NA,85
163,2,7.89885e+14,7.89885e+14,NA,399,399,NA,64,64,NA,335,335,NA,85
163,3,1.44136e+13,1.44136e+13,NA,624,624,NA,86,86,NA,538,538,NA,85
164,0,9.28884e+18,9.28884e+18,NA,420,420,NA,40,40,NA,380,380,NA,161
164,1,5.55688e+19,5.55688e+19,NA,567,567,NA,123,123,NA,444,444,NA,161
164,2,2.57467e+18,2.57467e+18,NA,561,561,NA,147,147,NA,414,414,NA,161
164,3,4664.48,4664.48,NA,510,510,NA,360,360,NA,150,150,NA,161
165,0,5.91114e+16,5.91114e+16,NA,367,367,NA,31,31,NA,336,336,NA,136
165,1,1.32509e+19,1.32509e+19,NA,512,512,NA,82,82,NA,430,430,NA,136
165,2,1.07681e+17,1.07681e+17,NA,420,420,NA,37,37,NA,383,383,NA,136
165,3,2.54781e+14,2.54781e+14,NA,594,594,NA,5,5,NA,589,589,NA,136
166,0,4.1872e+16,4.1872e+16,NA,355,355,NA,22,22,NA,333,333,NA,105
166,1,4.98919e+15,4.98919e+15,NA,362,362,NA,9,9,NA,353,353,NA,105
166,2,1.07393e+15,1.07393e+15,NA,400,400,NA,62,62,NA,338,338,NA,105
166,3,5.9299e+14,5.9299e+14,NA,699,699,NA,95,95,NA,604,604,NA,105
167,0,3.35324e+14,3.35324e+14,NA,311,311,NA,20,20,NA,291,291,NA,29
167,1,9.17321e+11,9.17321e+11,NA,284,284,NA,15,15,NA,269,269,NA,29
167,2,4.04351e+11,4.04351e+11,NA,278,278,NA,17,17,NA,261,261,NA,29
167,3,10083300000,10083300000,NA,424,424,NA,15,15,NA,409,409,NA,29
168,0,9.32498e+17,9.32498e+17,NA,428,428,NA,68,68,NA,360,360,NA,54
168,1,1.78715e+13,1.78715e+13,NA,403,403,NA,105,105,NA,298,298,NA,54
168,2,1.97985e+13,1.97985e+13,NA,402,402,NA,103,103,NA,299,299,NA,54
168,3,1.35366e+12,1.35366e+12,NA,496,496,NA,0,0,NA,496,496,NA,54
169,0,1.03396e+21,1.03396e+21,NA,457,457,NA,36,36,NA,421,421,NA,49
169,1,5.79412e+12,5.79412e+12,NA,400,400,NA,113,113,NA,287,287,NA,49
169,2,2.6918e+13,2.6918e+13,NA,406,406,NA,104,104,NA,302,302,NA,49
169,3,6.50947e+11,6.50947e+11,NA,488,488,NA,5,5,NA,483,483,NA,49
170,0,4.26929e+11,4.26929e+11,NA,247,247,NA,14,14,NA,233,233,NA,14
170,1,8.7037e+10,8.7037e+10,NA,249,249,NA,3,3,NA,246,246,NA,14
170,2,96421500000,96421500000,NA,264,264,NA,17,17,NA,247,247,NA,14
170,3,14955900000,14955900000,NA,416,416,NA,0,0,NA,416,416,NA,14
171,0,3.34025e+15,3.34025e+15,NA,345,345,NA,34,34,NA,311,311,NA,116
171,1,9.72008e+16,9.72008e+16,NA,393,393,NA,11,11,NA,382,382,NA,116
171,2,7.5147e+15,7.5147e+15,NA,372,372,NA,15,15,NA,357,357,NA,116
171,3,1230870,1230870,NA,321,321,NA,72,72,NA,249,249,NA,116
172,0,2.29373e+23,2.29373e+23,NA,509,509,NA,41,41,NA,468,468,NA,57
172,1,7.11096e+12,7.11096e+12,NA,446,446,NA,157,157,NA,289,289,NA,57
172,2,2.6918e+13,2.6918e+13,NA,439,439,NA,137,137,NA,302,302,NA,57
172,3,1.70667e+13,1.70667e+13,NA,544,544,NA,3,3,NA,541,541,NA,57
173,0,1.30624e+20,1.30624e+20,NA,431,431,NA,28,28,NA,403,403,NA,135
173,1,4.74654e+16,4.74654e+16,NA,416,416,NA,41,41,NA,375,375,NA,135
173,2,9.72008e+16,9.72008e+16,NA,414,414,NA,32,32,NA,382,382,NA,135
173,3,1.93499e+15,1.93499e+15,NA,626,626,NA,1,1,NA,625,625,NA,135
174,0,67874100000,67874100000,NA,217,217,NA,0,0,NA,217,217,NA,15
174,1,1.18335e+11,1.18335e+11,NA,254,254,NA,5,5,NA,249,249,NA,15
174,2,2.68459e+11,2.68459e+11,NA,261,261,NA,4,4,NA,257,257,NA,15
174,3,206992000,206992000,NA,340,340,NA,0,0,NA,340,340,NA,15
175,0,1.34223e+13,1.34223e+13,NA,295,295,NA,32,32,NA,263,263,NA,55
175,1,1.07681e+17,1.07681e+17,NA,456,456,NA,73,73,NA,383,383,NA,55
175,2,2.42981e+13,2.42981e+13,NA,406,406,NA,105,105,NA,301,301,NA,55
175,3,1.68476e+11,1.68476e+11,NA,477,477,NA,18,18,NA,459,459,NA,55
176,0,7.23934e+23,7.23934e+23,NA,628,628,NA,150,150,NA,478,478,NA,191
176,1,1.635e+23,1.635e+23,NA,744,744,NA,222,222,NA,522,522,NA,191
176,2,1.33222e+23,1.33222e+23,NA,658,658,NA,138,138,NA,520,520,NA,191
176,3,9.84408e+14,9.84408e+14,NA,805,805,NA,192,192,NA,613,613,NA,191
177,0,1.66955e+16,1.66955e+16,NA,325,325,NA,0,0,NA,325,325,NA,87
177,1,3.1429e+14,3.1429e+14,NA,365,365,NA,39,39,NA,326,326,NA,87
177,2,7.89885e+14,7.89885e+14,NA,350,350,NA,15,15,NA,335,335,NA,87
177,3,4583330000,4583330000,NA,395,395,NA,0,0,NA,395,395,NA,87
178,0,4.20349e+15,4.20349e+15,NA,348,348,NA,35,35,NA,313,313,NA,111
178,1,1.318e+15,1.318e+15,NA,366,366,NA,26,26,NA,340,340,NA,111
178,2,9.24735e+17,9.24735e+17,NA,448,448,NA,44,44,NA,404,404,NA,111
178,3,5.04054e+15,5.04054e+15,NA,676,676,NA,34,34,NA,642,642,NA,111
179,0,2.09288e+17,2.09288e+17,NA,381,381,NA,34,34,NA,347,347,NA,145
179,1,6.80153e+17,6.80153e+17,NA,426,426,NA,25,25,NA,401,401,NA,145
179,2,8.79762e+18,8.79762e+18,NA,462,462,NA,36,36,NA,426,426,NA,145
179,3,3.61852e+16,3.61852e+16,NA,677,677,NA,0,0,NA,677,677,NA,145
180,0,2.92033e+20,2.92033e+20,NA,448,448,NA,38,38,NA,410,410,NA,173
180,1,6.8198e+19,6.8198e+19,NA,509,509,NA,63,63,NA,446,446,NA,173
180,2,1.71398e+20,1.71398e+20,NA,549,549,NA,94,94,NA,455,455,NA,173
180,3,61.0217,61.0217,NA,73,73,NA,0,0,NA,73,73,NA,173
181,0,2.88651e+23,2.88651e+23,NA,480,480,NA,10,10,NA,470,470,NA,192
181,1,5.58678e+23,5.58678e+23,NA,539,539,NA,5,5,NA,534,534,NA,192
181,2,6.18916e+23,6.18916e+23,NA,565,565,NA,30,30,NA,535,535,NA,192
181,3,11710100,11710100,NA,289,289,NA,0,0,NA,289,289,NA,192
182,0,1.06245e+14,1.06245e+14,NA,285,285,NA,4,4,NA,281,281,NA,31
182,1,1.38167e+12,1.38167e+12,NA,277,277,NA,4,4,NA,273,273,NA,31
182,2,1.24719e+12,1.24719e+12,NA,276,276,NA,4,4,NA,272,272,NA,31
182,3,406872000,406872000,NA,356,356,NA,4,4,NA,352,352,NA,31
183,0,1.20582e+11,1.20582e+11,NA,234,234,NA,12,12,NA,222,222,NA,61
183,1,8.30265e+13,8.30265e+13,NA,335,335,NA,22,22,NA,313,313,NA,61
183,2,4.27309e+14,4.27309e+14,NA,343,343,NA,14,14,NA,329,329,NA,61
183,3,2760920000,2760920000,NA,400,400,NA,14,14,NA,386,386,NA,61
184,0,1.8729e+16,1.8729e+16,NA,387,387,NA,61,61,NA,326,326,NA,63
184,1,1.12883e+14,1.12883e+14,NA,325,325,NA,9,9,NA,316,316,NA,63
184,2,1.18653e+13,1.18653e+13,NA,354,354,NA,60,60,NA,294,294,NA,63
184,3,81016700000,81016700000,NA,455,455,NA,9,9,NA,446,446,NA,63
185,0,1.18724e+15,1.18724e+15,NA,345,345,NA,43,43,NA,302,302,NA,91
185,1,5.24424e+14,5.24424e+14,NA,349,349,NA,18,18,NA,331,331,NA,91
185,2,5.25833e+16,5.25833e+16,NA,410,410,NA,34,34,NA,376,376,NA,91
185,3,7.42817e+14,7.42817e+14,NA,621,621,NA,13,13,NA,608,608,NA,91
186,0,1.1554e+22,1.1554e+22,NA,493,493,NA,51,51,NA,442,442,NA,131
186,1,6.4534e+16,6.4534e+16,NA,470,470,NA,92,92,NA,378,378,NA,131
186,2,1.53475e+14,1.53475e+14,NA,434,434,NA,115,115,NA,319,319,NA,131
186,3,1.61321e+13,1.61321e+13,NA,540,540,NA,0,0,NA,540,540,NA,131
187,0,6.02702e+11,6.02702e+11,NA,248,248,NA,12,12,NA,236,236,NA,23
187,1,1.18335e+11,1.18335e+11,NA,262,262,NA,13,13,NA,249,249,NA,23
187,2,5.51233e+13,5.51233e+13,NA,319,319,NA,10,10,NA,309,309,NA,23
187,3,570440000,570440000,NA,359,359,NA,1,1,NA,358,358,NA,23
188,0,1.01803e+25,1.01803e+25,NA,506,506,NA,5,5,NA,501,501,NA,144
188,1,7.53489e+17,7.53489e+17,NA,419,419,NA,17,17,NA,402,402,NA,144
188,2,4.98919e+15,4.98919e+15,NA,373,373,NA,20,20,NA,353,353,NA,144
188,3,3.97219e+13,3.97219e+13,NA,560,560,NA,4,4,NA,556,556,NA,144
189,0,5.88823e+17,5.88823e+17,NA,368,368,NA,12,12,NA,356,356,NA,123
189,1,3.15135e+16,3.15135e+16,NA,381,381,NA,10,10,NA,371,371,NA,123
189,2,1.2539e+16,1.2539e+16,NA,389,389,NA,27,27,NA,362,362,NA,123
189,3,1.13586e+11,1.13586e+11,NA,461,461,NA,9,9,NA,452,452,NA,123
190,0,1.20582e+11,1.20582e+11,NA,240,240,NA,18,18,NA,222,222,NA,13
190,1,1.60889e+11,1.60889e+11,NA,265,265,NA,13,13,NA,252,252,NA,13
190,2,47084900000,47084900000,NA,265,265,NA,25,25,NA,240,240,NA,13
190,3,1969250000,1969250000,NA,384,384,NA,4,4,NA,380,380,NA,13
191,0,4.21985e+14,4.21985e+14,NA,313,313,NA,20,20,NA,293,293,NA,162
191,1,1.62625e+19,1.62625e+19,NA,444,444,NA,12,12,NA,432,432,NA,162
191,2,7.55513e+19,7.55513e+19,NA,507,507,NA,60,60,NA,447,447,NA,162
191,3,4.91193e+11,4.91193e+11,NA,502,502,NA,24,24,NA,478,478,NA,162
192,0,6.55433e+19,6.55433e+19,NA,410,410,NA,13,13,NA,397,397,NA,100
192,1,4.06527e+15,4.06527e+15,NA,355,355,NA,4,4,NA,351,351,NA,100
192,2,5.80969e+14,5.80969e+14,NA,350,350,NA,18,18,NA,332,332,NA,100
192,3,3.77901e+14,3.77901e+14,NA,597,597,NA,1,1,NA,596,596,NA,100
193,0,1.7089e+10,1.7089e+10,NA,209,209,NA,4,4,NA,205,205,NA,16
193,1,1.78236e+11,1.78236e+11,NA,261,261,NA,8,8,NA,253,253,NA,16
193,2,3.47245e+12,3.47245e+12,NA,288,288,NA,6,6,NA,282,282,NA,16
193,3,50639200,50639200,NA,324,324,NA,9,9,NA,315,315,NA,16
194,0,9.11025e+23,9.11025e+23,NA,551,551,NA,71,71,NA,480,480,NA,96
194,1,1.18972e+15,1.18972e+15,NA,498,498,NA,159,159,NA,339,339,NA,96
194,2,1.98517e+15,1.98517e+15,NA,492,492,NA,148,148,NA,344,344,NA,96
194,3,8.79545e+14,8.79545e+14,NA,613,613,NA,2,2,NA,611,611,NA,96
195,0,1.50571e+13,1.50571e+13,NA,352,352,NA,88,88,NA,264,264,NA,66
195,1,6.76512e+13,6.76512e+13,NA,345,345,NA,34,34,NA,311,311,NA,66
195,2,4.98919e+15,4.98919e+15,NA,408,408,NA,55,55,NA,353,353,NA,66
195,3,7.8079e+13,7.8079e+13,NA,600,600,NA,32,32,NA,568,568,NA,66
196,0,3.21304e+25,3.21304e+25,NA,552,552,NA,41,41,NA,511,511,NA,195
196,1,7.22637e+24,7.22637e+24,NA,660,660,NA,101,101,NA,559,559,NA,195
196,2,2.24693e+31,2.24693e+31,NA,811,811,NA,106,106,NA,705,705,NA,195
196,3,4.74252e+23,4.74252e+23,NA,988,988,NA,20,20,NA,968,968,NA,195
197,0,12105100000,12105100000,NA,206,206,NA,4,4,NA,202,202,NA,8
197,1,18734800000,18734800000,NA,247,247,NA,16,16,NA,231,231,NA,8
197,2,25471800000,25471800000,NA,244,244,NA,10,10,NA,234,234,NA,8
197,3,446639,446639,NA,247,247,NA,16,16,NA,231,231,NA,8
198,0,7.55523e+12,7.55523e+12,NA,290,290,NA,32,32,NA,258,258,NA,35
198,1,5.79412e+12,5.79412e+12,NA,329,329,NA,42,42,NA,287,287,NA,35
198,2,3.47245e+12,3.47245e+12,NA,334,334,NA,52,52,NA,282,282,NA,35
198,3,1351.18,1351.18,NA,130,130,NA,2,2,NA,128,128,NA,35
199,0,3.36629e+13,3.36629e+13,NA,280,280,NA,9,9,NA,271,271,NA,34
199,1,6.41886e+12,6.41886e+12,NA,301,301,NA,13,13,NA,288,288,NA,34
199,2,6.747e+11,6.747e+11,NA,279,279,NA,13,13,NA,266,266,NA,34
199,3,356551,356551,NA,227,227,NA,0,0,NA,227,227,NA,34
200,0,9.43423e+14,9.43423e+14,NA,380,380,NA,80,80,NA,300,300,NA,65
200,1,1.01896e+14,1.01896e+14,NA,417,417,NA,102,102,NA,315,315,NA,65
200,2,2.98204e+13,2.98204e+13,NA,424,424,NA,121,121,NA,303,303,NA,65
200,3,1.80555e+13,1.80555e+13,NA,557,557,NA,15,15,NA,542,542,NA,65
